#Slovenian characterDescriptions.dic
#A part of NonVisual Desktop Access (NVDA)
#URL: http://www.nvda-project.org/
#This file is covered by the GNU General Public License.

a	Ajdovščina
b	Bovec
c	Celje
č	Črnomelj
d	Dramlje
e	
f	Fram
g	Gorica
h	Hoče
i	Idrija
j	Jesenice
k	Kranj
l	Ljubljana
m	Maribor
n	
o	
p	Ptuj
q	quorum
r	Rateče
s	
š	Šentvid
t	
u	Unec
v	Velenje
w	Dvojni v
x	 Iks
y	Ipsilon
z	
ž Žalec
