#Aragonese characterDescriptions.dic
#A part of NonVisual Desktop Access (NVDA)
#URL: http://www.nvda-project.org/
#This file is covered by the GNU General Public License.
# Traduciu por Jorgtum
# Softaragonés

a	Ababol
b	Bardo
c	Calient
d	Dalla
e	Encorrer
f	Farto
g	Garrampa
h	Hivierno
i	Ibón
j	Jota
k	Kilo
l	Lifara
m	Masar
n	Noviembre
o	Olivera
p	Pretar
q	Qüestión
r	Royo
s	Sequera
t	Teta
u	Ulorar
v	Viello
w	Wisky
x	Xuto
y	Yayo
z	Zapo
