# Discriminant Reading Dictionary for NVDA Japanese
# Copyright (C) 2012 Teruyoshi Fujinuma, Takuya Nishimoto

!	ハンカク カンタンフ
"	ハンカク ダブル コーテーション
\#	ハンカク シャープ
$	ハンカク ドルマーク
%	ハンカク パーセント
&	ハンカク アンド
'	ハンカク シングル コーテーション
(	ハンカク カッコ
)	ハンカク トジ カッコ
*	ハンカク アスタリスク
+	ハンカク プラス
,	ハンカク コンマ
-	ハンカク マイナス
.	ハンカク ピリオド
/	ハンカク スラッシュ
0	ハンカク ゼロ
1	ハンカク イチ
2	ハンカク ニ
3	ハンカク サン
4	ハンカク ヨン
5	ハンカク ゴ
6	ハンカク ロク
7	ハンカク ナナ
8	ハンカク ハチ
9	ハンカク キュー
:	ハンカク コロン
;	ハンカク セミコロン
<	ハンカク ショーナリ
=	ハンカク イコール
>	ハンカク ダイナリ
?	ハンカク クエスチョンマーク
@	ハンカク アットマーク
[	ハンカク ダイカッコ
\	ハンカク エンマーク
]	ハンカク トジ ダイカッコ
^	ハンカク ベキジョー
_	ハンカク アンダーライン
`	ハンカク アクサングラーブ
{	ハンカク チューカッコ
| 	ハンカク タテセン
}	ハンカク トジ チューカッコ
~	ハンカク チルダ
｡	ハンカク クテン
｢	ハンカク カギ
｣	ハンカク トジカギ
､	ハンカク トーテン
･	ハンカク ナカテン
ｰ	ハンカク チョーオン
ﾞ	ハンカク ダクテン
ﾟ	ハンカク ハンダクテン
　	ゼンカク スペース
、	ゼンカク トーテン
。	ゼンカク くてん
，	ゼンカク コンマ
．	ゼンカク ピリオド
・	ゼンカク ナカテン
：	ゼンカク コロン
；	ゼンカク セミコロン
？	ゼンカク ギモンフ
！	ゼンカク カンタンフ
゛	ダクテン
゜	ハンダクテン
´	ゼンカク アクサンテギュー
｀	ゼンカク アクサングラーブ
¨	ゼンカク ウムラウト
＾	ゼンカク ベキジョー
￣	ゼンカク オーバーライン
＿	ゼンカク アンダーライン
ヽ	カタカナ クリカエシ キゴー
ヾ	カタカナ クリカエシ ダクテン キゴー
ゝ	クリカエシ キゴー
ゞ	クリカエシ ダクテン キゴー
〃	オナジク キゴー
仝	ドージョー キゴー
々	オドリジ キゴー
〆	シメ キゴー
〇	カンスージノ レイ
ー	ゼンカク チョーオン
―	ゼンカク ダッシュ
‐	ゼンカク ハイフン
／	ゼンカク スラッシュ
＼	ゼンカク バックスラッシュ
～	ゼンカク ナミセン
∥	ゼンカク タテヘイコー
｜	ゼンカク タテボー
…	サンテン リーダ
‥	ニテン リーダ
‘	ゼンカク シングル コーテーション
’	ゼンカク トジシングル コーテーション
“	ゼンカク ダブル コーテーション
”	ゼンカク トジ ダブル コーテーション 
（	ゼンカク ヒラキ カッコ
）	ゼンカク トジ カッコ
〔	ゼンカク ヒラキ キッコー カッコ
〕	ゼンカク トジ キッコー カッコ
［	ゼンカク ヒラキ ダイカッコ カクカッコ
］	ゼンカク トジ ダイカッコ トジカクカッコ
｛	ヒラキ チューカッコ
｝	トジ チューカッコ
〈	ヒラキ ヤマカッコ
〉	トジ ヤマカッコ
《	ニジューヤマカッコ
》	トジ ニジューヤマカッコ
「	ゼンカク カギカッコ
」	ゼンカク トジカギカッコ
『	ニジュウカギカッコ
』	トジ ニジュウカギカッコ
【	クロカッコ
】	トジ クロカッコ
＋	ゼンカク プラス
－	ゼンカク マイナス
±	プラスマイナス
×	カケル
÷	ワル
＝	ゼンカク イコール
≠	ノットイコール
＜	ゼンカク ショーナリ
＞	ゼンカク ダイナリ
≦	ショーナリイコール
≧	ダイナリイコール
∞	ムゲンダイ
∴	ユエニ
♂	オス
♀	メス
°	カクドノ ド
′	カクドノ フン
″	カクドノ ビョー
℃	オンドノ ドシー
￥	ゼンカク エンマーク
＄	ゼンカク ドルマーク
￠	セント キゴー
￡	ポンド キゴー
％	ゼンカク パーセント
＃	ゼンカク シャープ イゲタ キゴー
＆	ゼンカク アンド アンパサンド
＊	ゼンカク アスタリスク
＠	ゼンカク アットマーク
§	セクション キゴー
☆	ホシジルシ キゴー
★	クロボシ キゴー
○	マルジルシ キゴー
●	クロマル キゴー
◎	ニジューマル キゴー
◇	ヒシガタ キゴー
◆	クロヒシガタ キゴー
□	シカク キゴー
■	クロシカク キゴー
△	サンカク キゴー
▲	クロサンカク キゴー
▽	ギャクサンカク キゴー
▼	クロギャクサンカク キゴー
※	コメジルシ キゴー
〒	ユービン キゴー
→	ミギヤジルシ キゴー
←	ヒダリヤジルシ キゴー
↑	ウエヤジルシ キゴー
↓	シタヤジルシ キゴー
〓	ゲタキゴー クギリキゴー
∈	スーガク ゾクスル キゴー
∋	スーガク モトトシテ フクム キゴー
⊆	スーガク ブブン シューゴー キゴー
⊇	スーガク ブブンオ モトトシテ フクム キゴー
⊂	スーガク シンブブン シューゴー キゴー
⊃	スーガク シンブオ モトトシテ フクム キゴー
∪	スーガク ガッペイ シューゴー キゴー カップ
∩	スーガク キョーツー シューゴー キゴー キャップ
∧	スーガク ゴーセツ キゴー オヨビ
∨	スーガク リセツ キゴー マタワ
￢	スーガク ヒテイ キゴー
⇒	ゴーイ キゴー
⇔	ドーチ キゴー
∀	フツー ゲンテイシ
∃	ソンザイ ゲンテイシ
∠	カク キゴー
⊥	スイチョク
⌒	コキゴー
∂	ラウンドディー
∇	ナブラ キゴー
≡	ゴードー
≒	ニアリーイコール
≪	ヒジョーニ チイサイ キゴー
≫	ヒジョーニ オーキイ キゴー
√	コンキゴー
∽	ソージ キゴー
∝	ヒレイ キゴー
∵	ナゼナラバ
∫	スーガク セキブン キゴー インテグラル
∬	スーガク ニジュー セキブン キゴー ダブルインテグラル
Å	タンイノ オングストローム
‰	タンイノ パーミル
♯	オンプ キゴーノ シャープ
♭	オンプ キゴーノ フラット
♪	オンプ キゴー
†	ダガー
‡	ダブルダガー
¶	ダンラク キゴー
◯	キゴーノ ゴーセイヨー マル
①	マルノ ナカニ イチ
②	マルノ ナカニ ニ
③	マルノ ナカニ サン
④	マルノ ナカニ ヨン
⑤	マルノ ナカニ ゴ
⑥	マルノ ナカニ ロク
⑦	マルノ ナカニ ナナ
⑧	マルノ ナカニ ハチ
⑨	マルノ ナカニ キュー
⑩	マルノ ナカニ ジュー
⑪	マルノ ナカニ ジューイチ
⑫	マルノ ナカニ ジューニ
⑬	マルノ ナカニ ジューサン
⑭	マルノ ナカニ ジューヨン
⑮	マルノ ナカニ ジューゴ
⑯	マルノ ナカニ ジューロク
⑰	マルノ ナカニ ジューナナ
⑱	マルノ ナカニ ジューハチ
⑲	マルノ ナカニ ジューク
⑳	マルノ ナカニ ニジュー
Ⅰ	ローマスージ オオモジノ イチ
Ⅱ	ローマスージ オオモジノ ニ
Ⅲ	ローマスージ オオモジノ サン
Ⅳ	ローマスージ オオモジノ ヨン
Ⅴ	ローマスージ オオモジノ ゴ
Ⅵ	ローマスージ オオモジノ ロク
Ⅶ	ローマスージ オオモジノ ナナ
Ⅷ	ローマスージ オオモジノ ハチ
Ⅸ	ローマスージ オオモジノ キュー
Ⅹ	ローマスージ オオモジノ ジュー
㍉	タンイノ カナミリ
㌔	タンイノ カナキロ
㌢	タンイノ カナセンチ
㍍	タンイノ カナメートル
㌘	タンイノ カナグラム
㌧	タンイノ カナトン
㌃	タンイノ カナアール
㌶	タンイノ カナヘクタール
㍑	タンイノ カナリットル
㍗	タンイノ カナワッット
㌍	タンイノ カナカロリー
㌦	タンイノ カナドル
㌣	タンイノ カナセント
㌫	タンイノ カナパーセント
㍊	タンイノ カナミリバール
㌻	タンイノ カナページ
㎜	タンイノ ミリメートル
㎝	タンイノ センチメートル
㎞	タンイノ キロメートル
㎎	タンイノ ミリグラム
㎏	タンイノ キログラム
㏄	タンイノ シーシー
㎡	タンイノ ヘイホーメートル
㍻	ゲンゴー ヘイセイ
〝	ヒゲヒラキ キゴー
〟	トジヒゲ キゴー
№	ナンバー キゴー
㏍	ケイケイ キゴー
℡	テレフォン キゴー
㊤	マルノ ナカニ ウエ
㊥	マルノ ナカニ ナカ
㊦	マルノ ナカニ シタ
㊧	マルノ ナカニ ヒダリ
㊨	マルノ ナカニ ミギ
㈱	カッコノ ナカニ カブ カブシキガイシャ
㈲	カッコノ ナカニ ユーゲン ユーゲンガイシャ
㈹	カッコノ ナカニ ダイヒョー
㍾	ゲンゴー メイジ
㍽	ゲンゴー タイショー
㍼	ゲンゴー ショーワ
∮	スーガク コンターインテグラル キゴー
∑	スーガク シグマ キゴー
∟	スーガク チョッカク キゴー
⊿	スーガク サンカクケイ キゴー
ⅰ	ローマスージ コモジノ イチ
ⅱ	ローマスージ コモジノ ニ
ⅲ	ローマスージ コモジノ サン
ⅳ	ローマスージ コモジノ ヨン
ⅴ	ローマスージ コモジノ ゴ
ⅵ	ローマスージ コモジノ ロク
ⅶ	ローマスージ コモジノ ナナ
ⅷ	ローマスージ コモジノ ハチ
ⅸ	ローマスージ コモジノ キュー
ⅹ	ローマスージ コモジノ ジュー
￤	ハダン キゴー
＇	ゼンカク アポストロフィー
＂	ゼンカク コーテーション
ｦ	ハンカク オワリノ オ
ｧ	ハンカク コモジノアサヒノア
ｨ	ハンカク コモジノイロハノイ
ｩ	ハンカク コモジノウエノノウ
ｪ	ハンカク コモジノエイゴノエ
ｫ	ハンカク コモジノオオサカノオ
ｬ	ハンカク コモジノヤマトノヤ
ｭ	ハンカク コモジノユミヤノユ
ｮ	ハンカク コモジノヨシノノヨ
ｯ	ハンカク コモジノツルカメノツ
ｱ	ハンカク アサヒノア
ｲ	ハンカク イロハノイ
ｳ	ハンカク ウエノノウ
ｴ	ハンカク エイゴノエ
ｵ	ハンカク オオサカノオ
ｶ	ハンカク カワセノカ
ｷ	ハンカク キッテノキ
ｸ	ハンカク クラブノク
ｹ	ハンカク ケシキノケ
ｺ	ハンカク コドモノコ
ｻ	ハンカク サクラノサ
ｼ	ハンカク シンブンノシ
ｽ	ハンカク スズメノス
ｾ	ハンカク セカイノセ
ｿ	ハンカク ソロバンノソ
ﾀ	ハンカク タバコノタ
ﾁ	ハンカク チドリノチ
ﾂ	ハンカク ツルカメノツ
ﾃ	ハンカク テガミノテ
ﾄ	ハンカク トーキョーノト
ﾅ	ハンカク ナマエノナ
ﾆ	ハンカク ニホンノニ
ﾇ	ハンカク ヌマズノヌ
ﾈ	ハンカク ネズミノネ
ﾉ	ハンカク ノヤマノノ
ﾊ	ハンカク ハガキノハ
ﾋ	ハンカク ヒコーキノヒ
ﾌ	ハンカク フジサンノフ
ﾍ	ハンカク ヘイワノヘ
ﾎ	ハンカク ホケンノホ
ﾏ	ハンカク マッチノマ
ﾐ	ハンカク ミカサノミ
ﾑ	ハンカク ムセンノム
ﾒ	ハンカク メイジノメ
ﾓ	ハンカク モミジノモ
ﾔ	ハンカク ヤマトノヤ
ﾕ	ハンカク ユミヤノユ
ﾖ	ハンカク ヨシノノヨ
ﾗ	ハンカク ラジオノラ
ﾘ	ハンカク リンゴノリ
ﾙ	ハンカク ルスバンノル
ﾚ	ハンカク レンゲノレ
ﾛ	ハンカク ローマノロ
ﾜ	ハンカク ワラビノワ
ﾝ	ハンカク オシマイノン
ぁ	コモジノ アサヒノ ア
あ	アサヒノ ア
ぃ	コモジノ イロハノ イ
い	イロハノ イ
ぅ	コモジノ ウエノノ ウ
う	ウエノノ ウ
ぇ	コモジノ エイゴノ エ
え	エイゴノ エ
ぉ	コモジノ オオサカノ オ
お	オオサカノ オ
か	カワセノ カ
が	カワセノ カニ ダクテン
き	キッテノ キ
ぎ	キッテノ キニ ダクテン
く	クラブノ ク
ぐ	クラブノ クニ ダクテン
け	ケシキノ ケ
げ	ケシキノ ケニ ダクテン
こ	コドモノ コ
ご	コドモノ コニ ダクテン
さ	サクラノ サ
ざ	サクラノ サニ ダクテン
し	シンブンノ シ
じ	シンブンノ シニ ダクテン
す	スズメノ ス
ず	スズメノ スニ ダクテン
せ	セカイノ セ
ぜ	セカイノ セニ ダクテン
そ	ソロバンノ ソ
ぞ	ソロバンノ ソニ ダクテン
た	タンボノ タ
だ	タンボノ タニ ダクテン
ち	チドリノ チ
ぢ	チドリノ チニ ダクテン
っ	コモジノ ツルカメノ ツ
つ	ツルカメノ ツ
づ	ツルカメノ ツニ ダクテン
て	テガミノ テ
で	テガミノ テニ ダクテン
と	トーキョーノ ト
ど	トーキョーノ トニ ダクテン
な	ナマエノ ナ
に	ニホンノ ニ
ぬ	ヌマズノ ヌ
ね	ネズミノ ネ
の	ノヤマノ ノ
は	ハガキノ ハ
ば	ハガキノ ハニ ダクテン
ぱ	ハガキノ ハニ ハンダクテン
ひ	ヒコーキノ ヒ
び	ヒコーキノ ヒニ ダクテン
ぴ	ヒコーキノ ヒニ ハンダクテン
ふ	フジサンノ フ
ぶ	フジサンノ フニ ダクテン
ぷ	フジサンノ フニ ハンダクテン
へ	ヘイワノ ヘ
べ	ヘイワノ ヘニ ダクテン
ぺ	ヘイワノ ヘニ ハンダクテン
ほ	ホケンノ ホ
ぼ	ホケンノ ホニ ダクテン
ぽ	ホケンノ ホニ ハンダクテン
ま	マッチノ マ
み	ミカサノ ミ
む	ムセンノ ム
め	メイジノ メ
も	モミジノ モ
ゃ	コモジノ ヤマトノ ヤ
や	ヤマトノ ヤ
ゅ	コモジノ ユミヤノ ユ
ゆ	ユミヤノ ユ
ょ	コモジノ ヨシノノ ヨ
よ	ヨシノノ ヨ
ら	ラジオノ ラ
り	リンゴノ リ
る	ルスバンノ ル
れ	レンゲノ レ
ろ	ローマノ ロ
ゎ	コモジノ ワラビノ ワ
わ	ワラビノ ワ
ゐ	イドノ イ
ゑ	カギノ アル エ
を	オワリノ オ
ん	オシマイノ ン
ァ	カタカナ コモジノ アサヒノ ア
ア	カタカナ アサヒノ ア
ィ	カタカナ コモジノ イロハノ イ
イ	カタカナ イロハノ イ
ゥ	カタカナ コモジノ ウエノノ ウ
ウ	カタカナ ウエノノ ウ
ェ	カタカナ コモジノ エイゴノ エ
エ	カタカナ エイゴノ エ
ォ	カタカナ コモジノ オオサカノ オ
オ	カタカナ オオサカノ オ
カ	カタカナ カワセノ カ
ガ	カタカナ カワセノ カニ ダクテン
キ	カタカナ キッテノ キ
ギ	カタカナ キッテノ キニ ダクテン
ク	カタカナ クラブノ ク
グ	カタカナ クラブノ クニ ダクテン
ケ	カタカナ ケシキノ ケ
ゲ	カタカナ ケシキノ ケニ ダクテン
コ	カタカナ コドモノ コ
ゴ	カタカナ コドモノ コニ ダクテン
サ	カタカナ サクラノ サ
ザ	カタカナ サクラノ サニ ダクテン
シ	カタカナ シンブンノ シ
ジ	カタカナ シンブンノ シニ ダクテン
ス	カタカナ スズメノ ス
ズ	カタカナ スズメノ スニ ダクテン
セ	カタカナ セカイノ セ
ゼ	カタカナ セカイノ セニ ダクテン
ソ	カタカナ ソロバンノ ソ
ゾ	カタカナ ソロバンノ ソニ ダクテン
タ	カタカナ タンボノ タ
ダ	カタカナ タンボノ タニ ダクテン
チ	カタカナ チドリノ チ
ヂ	カタカナ チドリノ チニ ダクテン
ッ	カタカナ コモジノ ツルカメノ ツ
ツ	カタカナ ツルカメノ ツ
ヅ	カタカナ ツルカメノ ツニ ダクテン
テ	カタカナ テガミノ テ
デ	カタカナ テガミノ テニ ダクテン
ト	カタカナ トーキョーノ ト
ド	カタカナ トーキョーノ トニ ダクテン
ナ	カタカナ ナマエノ ナ
ニ	カタカナ ニホンノ ニ
ヌ	カタカナ ヌマズノ ヌ
ネ	カタカナ ネズミノ ネ
ノ	カタカナ ノヤマノ ノ
ハ	カタカナ ハガキノ ハ
バ	カタカナ ハガキノ ハニ ダクテン
パ	カタカナ ハガキノ ハニ ハンダクテン
ヒ	カタカナ ヒコーキノ ヒ
ビ	カタカナ ヒコーキノ ヒニ ダクテン
ピ	カタカナ ヒコーキノ ヒニ ハンダクテン
フ	カタカナ フジサンノ フ
ブ	カタカナ フジサンノ フニ ダクテン
プ	カタカナ フジサンノ フニ ハンダクテン
ヘ	カタカナ ヘイワノ ヘ
ベ	カタカナ ヘイワノ ヘニ ダクテン
ペ	カタカナ ヘイワノ ヘニ ハンダクテン
ホ	カタカナ ホケンノ ホ
ボ	カタカナ ホケンノ ホニ ダクテン
ポ	カタカナ ホケンノ ホニ ハンダクテン
マ	カタカナ マッチノ マ
ミ	カタカナ ミカサノ ミ
ム	カタカナ ムセンノ ム
メ	カタカナ メイジノ メ
モ	カタカナ モミジノ モ
ャ	カタカナ コモジノ ヤマトノ ヤ
ヤ	カタカナ ヤマトノ ヤ
ュ	カタカナ コモジノ ユミヤノ ユ
ユ	カタカナ ユミヤノ ユ
ョ	カタカナ コモジノ ヨシノノ ヨ
ヨ	カタカナ ヨシノノ ヨ
ラ	カタカナ ラジオノ ラ
リ	カタカナ リンゴノ リ
ル	カタカナ ルスバンノ ル
レ	カタカナ レンゲノ レ
ロ	カタカナ ローマノ ロ
ヮ	カタカナ コモジノ ワラビノ ワ
ワ	カタカナ ワラビノ ワ
ヰ	カタカナ イドノ イ
ヱ	カタカナ カギノ アル エ
ヲ	カタカナ オワリノ オ
ン	カタカナ オシマイノ ン
ヴ	カタカナ ウエノノ ウニ ダクテン
ヵ	カタカナ コモジノ カワセノ カ
ヶ	カタカナ コモジノ ケシキノ ケ
A	オーモジ エー アルファー
B	オーモジ ビー ブラボー
C	オーモジ シー チャーリー
D	オーモジ ディー デルタ
E	オーモジ イー エコー
F	オーモジ エフ フォックスロット
G	オーモジ ジー ゴルフ
H	オーモジ エイチ ホテル
I	オーモジ アイ インディア
J	オーモジ ジェー ジュリエット
K	オーモジ ケー キロ
L	オーモジ エル リマ
M	オーモジ エム マイク
N	オーモジ エヌ ノベンバ
O	オーモジ オー オスカー
P	オーモジ ピー パパ
Q	オーモジ キュー ケベック
R	オーモジ アール ロメオ
S	オーモジ エス シアラー
T	オーモジ ティー タンゴ
U	オーモジ ユー ユニフォーム
V	オーモジ ブイ ヴィクター
W	オーモジ ダブリュー ウィスキー
X	オーモジ エックス エクスレイ
Y	オーモジ ワイ ヤンキー
Z	オーモジ ゼット ズール
a	エー アルファー
b	ビー ブラボー
c	シー チャーリー
d	ディー デルタ
e	イー エコー
f	エフ フォックスロット
g	ジー ゴルフ
h	エイチ ホテル
i	アイ インディア
j	ジェー ジュリエット
k	ケー キロ
l	エル リマ
m	エム マイク
n	エヌ ノベンバ
o	オー オスカー
p	ピー パパ
q	キュー ケベック
r	アール ロメオ
s	エス シアラー
t	ティー タンゴ
u	ユー ユニフォーム
v	ブイ ヴィクター
w	ダブリュー ウィスキー
x	エックス エクスレイ
y	ワイ ヤンキー
z	ゼット ズール
Ａ	オーモジ ゼンカク エー アルファー
Ｂ	オーモジ ゼンカク ビー ブラボー
Ｃ	オーモジ ゼンカク シー チャーリー
Ｄ	オーモジ ゼンカク ディー デルタ
Ｅ	オーモジ ゼンカク イー エコー
Ｆ	オーモジ ゼンカク エフ フォックスロット
Ｇ	オーモジ ゼンカク ジー ゴルフ
Ｈ	オーモジ ゼンカク エイチ ホテル
Ｉ	オーモジ ゼンカク アイ インディア
Ｊ	オーモジ ゼンカク ジェー ジュリエット
Ｋ	オーモジ ゼンカク ケー キロ
Ｌ	オーモジ ゼンカク エル リマ
Ｍ	オーモジ ゼンカク エム マイク
Ｎ	オーモジ ゼンカク エヌ ノベンバ
Ｏ	オーモジ ゼンカク オー オスカー
Ｐ	オーモジ ゼンカク ピー パパ
Ｑ	オーモジ ゼンカク キュー ケベック
Ｒ	オーモジ ゼンカク アール ロメオ
Ｓ	オーモジ ゼンカク エス シアラー
Ｔ	オーモジ ゼンカク ティー タンゴ
Ｕ	オーモジ ゼンカク ユー ユニフォーム
Ｖ	オーモジ ゼンカク ブイ ヴィクター
Ｗ	オーモジ ゼンカク ダブリュー ウィスキー
Ｘ	オーモジ ゼンカク エックス エクスレイ
Ｙ	オーモジ ゼンカク ワイ ヤンキー
Ｚ	オーモジ ゼンカク ゼット ズール
ａ	ゼンカク エー アルファー
ｂ	ゼンカク ビー ブラボー
ｃ	ゼンカク シー チャーリー
ｄ	ゼンカク ディー デルタ
ｅ	ゼンカク イー エコー
ｆ	ゼンカク エフ フォックスロット
ｇ	ゼンカク ジー ゴルフ
ｈ	ゼンカク エイチ ホテル
ｉ	ゼンカク アイ インディア
ｊ	ゼンカク ジェー ジュリエット
ｋ	ゼンカク ケー キロワット
ｌ	ゼンカク エル リマ
ｍ	ゼンカク エム マイク
ｎ	ゼンカク エヌ ノベンバ
ｏ	ゼンカク オー オスカー
ｐ	ゼンカク ピー パパ
ｑ	ゼンカク キュー ケベック
ｒ	ゼンカク アール ロメオ
ｓ	ゼンカク エス シアラー
ｔ	ゼンカク ティー タンゴ
ｕ	ゼンカク ユー ユニフォーム
ｖ	ゼンカク ブイ ヴィクター
ｗ	ゼンカク ダブリュー ウィスキー
ｘ	ゼンカク エックス エクスレイ
ｙ	ゼンカク ワイ ヤンキー
ｚ	ゼンカク ゼット ズール
Α	ギリシア オーモジ アルファ
Β	ギリシア オーモジ ベータ
Γ	ギリシア オーモジ ガンマ
Δ	ギリシア オーモジ デルタ
Ε	ギリシア オーモジ イプシロン
Ζ	ギリシア オーモジ ツェータ
Η	ギリシア オーモジ イータ
Θ	ギリシア オーモジ シータ
Ι	ギリシア オーモジ イオータ
Κ	ギリシア オーモジ カッパ
Λ	ギリシア オーモジ ラムダ
Μ	ギリシア オーモジ ミュー
Ν	ギリシア オーモジ ニュー
Ξ	ギリシア オーモジ グサイ
Ο	ギリシア オーモジ オミクロン
Π	ギリシア オーモジ パイ
Ρ	ギリシア オーモジ ロー
Σ	ギリシア オーモジ シグマ
Τ	ギリシア オーモジ タウ
Υ	ギリシア オーモジ ウプシロン
Φ	ギリシア オーモジ ファイ
Χ	ギリシア オーモジ カイ
Ψ	ギリシア オーモジ プサイ
Ω	ギリシア オーモジ オメガ
α	ギリシア アルファ
β	ギリシア ベータ
γ	ギリシア ガンマ
δ	ギリシア デルタ
ε	ギリシア イプシロン
ζ	ギリシア ツェータ
η	ギリシア イータ
θ	ギリシア シータ
ι	ギリシア イオータ
κ	ギリシア カッパ
λ	ギリシア ラムダ
μ	ギリシア ミュー
ν	ギリシア ニュー
ξ	ギリシア グサイ
ο	ギリシア オミクロン
π	ギリシア パイ
ρ	ギリシア ロー
σ	ギリシア シグマ
τ	ギリシア タウ
υ	ギリシア ウプシロン
φ	ギリシア ファイ
χ	ギリシア カイ
ψ	ギリシア プサイ
ω	ギリシア オメガ
А	ロシア オーモジ アー
Б	ロシア オーモジ ベー
В	ロシア オーモジ ブエー
Г	ロシア オーモジ ゲー
Д	ロシア オーモジ デー
Е	ロシア オーモジ イエー
Ё	ロシア オーモジ ヨー
Ж	ロシア オーモジ ジェー
З	ロシア オーモジ ゼー
И	ロシア オーモジ イー
Й	ロシア オーモジ イークラトコエ
К	ロシア オーモジ カー
Л	ロシア オーモジ エリ
М	ロシア オーモジ エム
Н	ロシア オーモジ エヌ
О	ロシア オーモジ オー
П	ロシア オーモジ ペー
Р	ロシア オーモジ エル
С	ロシア オーモジ エス
Т	ロシア オーモジ テー
У	ロシア オーモジ ウー
Ф	ロシア オーモジ エフ
Х	ロシア オーモジ ハー
Ц	ロシア オーモジ ツェー
Ч	ロシア オーモジ チェー
Ш	ロシア オーモジ シアー
Щ	ロシア オーモジ シシャー
Ъ	ロシア オーモジ トゥブョールドゥィズナーク
Ы	ロシア オーモジ ウイ
Ь	ロシア オーモジ ミャーフキーズナーク
Э	ロシア オーモジ エー
Ю	ロシア オーモジ ユー
Я	ロシア オーモジ ヤー
а	ロシア アー
б	ロシア ベー
в	ロシア ブエー
г	ロシア ゲー
д	ロシア デー
е	ロシア イエー
ё	ロシア ヨー
ж	ロシア ジェー
з	ロシア ゼー
и	ロシア イー
й	ロシア イークラトコエ
к	ロシア カー
л	ロシア エリ
м	ロシア エム
н	ロシア エヌ
о	ロシア オー
п	ロシア ペー
р	ロシア エル
с	ロシア エス
т	ロシア テー
у	ロシア ウー
ф	ロシア エフ
х	ロシア ハー
ц	ロシア ツェー
ч	ロシア チェー
ш	ロシア シアー
щ	ロシア シシャー
ъ	ロシア トゥブョールドゥィズナーク
ы	ロシア ウイ
ь	ロシア ミャーフキーズナーク
э	ロシア エー
ю	ロシア ユー
я	ロシア ヤー
┌	ケイセン ヒダリウエ
┐	ケイセン ミギウエ
┘	ケイセン ミギシタ
└	ケイセン ヒダリシタ
├	ケイセン タテセンミギ
┬	ケイセン ヨコセンシタ
┤	ケイセン タテセンヒダリ
┴	ケイセン ヨコセンウエ
┼	ケイセン クロス
┣	ケイセン タテセンミギ ダイ
┳	ケイセン ヨコセンシタ ダイ
┫	ケイセン タテセンヒダリ ダイ
┻	ケイセン ヨコセンウエ ダイ
╋	ケイセン クロス ダイ
┠	ケイセン タテセンミギ クミ
┯	ケイセン ヨコセンシタ クミ
┨	ケイセン タテセンヒダリ クミ
┷	ケイセン ヨコセンウエ クミ
┿	ケイセン ヨコフト クロス クミ
┝	ケイセン タテセンミギ クミ
┰	ケイセン ヨコセンシタ クミ
┥	ケイセン タテセンヒダリ クミ
┸	ケイセン ヨコセンウエ クミ
╂	ケイセン タテフト クロス クミ
亜	アネッタイノ ア
唖	アゼント スルノ ア、クチノ キケナイ ヨース
娃	オンナヘンニ ツチフタツ ウツクシイノ ア
阿	コザトヘンノ アベノ ア
哀	アワレ アイシューノ アイ
愛	イトシ アイジョーノ アイ
挨	アイサツノ アイ
姶	オンナヘンニ アウノ アイ
逢	イッショニ ナル イミノ アウ
葵	ショクブツノ アオイ
茜	アカネイロノ アカネ
穐	ノギヘンニ カメノ アキ
悪	ワルイノ アク
握	ニギルノ アク
渥	サンズイノ アツ
旭	キョクジツノ キョクノ アサヒ
葦	ミズベノ ショクブツノ アシ
芦	クサカンムリニ トノ アシ
鯵	サカナノ アジ
梓	キヘンニ カライノ アズサ
圧	アツリョクノ アツ
斡	アッセンスルノ アツ
扱	アツカウノ アツカ
宛	アテナノ アテ
姐	オンナヘン アネゴノ アネ
虻	ムシノ アブ
飴	アメダマノ アメ
絢	アヤ ケンランタルノ ケン
綾	アヤオリノ アヤ
鮎	サカナノ アユ
或	アルイワノ アル
粟	コクモツノ アワノ アワ
袷	コロモヘンニ アワセルノ アワセ
安	ヤス アンシンノ アン
庵	イオリノ アン
按	アンマノ アン
暗	クライノ アン
案	アンナイノ アン
闇	ヤミノ アン
鞍	ウマノ クラノ アン
杏	キノ シタニ クチノ アンズ
以	イジョー イカノ イ
伊	ニンベンノ イトーノ イ
位	クライノ イ
依	イゾンスルノ イ
偉	エライノ イ
囲	カコムノ イ
夷	イテキノ イ
委	ユダネルノ イ
威	ケンイノ イ
尉	チューイ タイイノ イ
惟	リッシンベンニ フルトリノ イ
意	イケンノ イ
慰	ナグサメルノ イ
易	ヤサシイノ イ
椅	コシカケルノ イ
為	コーイノ イ
畏	オソレルノ イ
異	コトナルノ イ
移	イドースルノ イ
維	メイジ イシンノ イ
緯	イド ケイドノ イ
胃	イブクロノ イ
萎	シボム イシュクノ イ
衣	コロモノ イ
謂	イワユルノ イ
違	チガウノ イ
遺	イサンノ イ
医	イシャノ イ
井	イドミズノ イ
亥	エトノ イノシシノ イ
域	チイキノ イキ
育	キョーイクノ イク
郁	カオルノ イク
磯	イソヅリノ イソ
一	カンスージノ イチ
壱	キン イチマンエンノ イチ
溢	アフレルノ イツ
逸	イツダツノ イツ
稲	オコメノ イネ
茨	イバラキケンノ イバラ
芋	サツマイモノ イモ
鰯	サカナノ イワシ
允	マコトノ イン
印	シルシノ イン
咽	ノド イントーノ イン
員	ジンインノ イン
因	ゲンインノ イン
姻	コンインノ イン
引	ヒク インリョクノ イン
飲	ノムノ イン
淫	ミダラ インランノ イン
胤	タネ ゴラクインノ イン
蔭	クサカンムリノ カゲノ イン
院	ビョーインノ イン
陰	カゲ インキノ イン
隠	カクレルノ イン
韻	インヲ フムノ イン
吋	ナガサ クチニ スンノ インチ
右	ミギヒダリノ ミギ
宇	ウチューノ ウ
烏	トリノ カラス
羽	ハネノ ウ
迂	ウカイスルノ ウ
雨	アメガ フルノ アメ
卯	エトノ ウサギノ ウ
鵜	トリノ ウ
窺	ウカガウノ ウ
丑	エトノ ウシ
碓	イシヘンニ フルドリノ ウス
臼	イシウスノ ウス
渦	ウズマキノ ウズ
嘘	クチヘンニ キョノ ウソ
唄	クチヘンニ カイノ ウタ
欝	ユーウツノ ウツ
蔚	クサカンムリニ イノ ウツ
鰻	サカナノ ウナギ
姥	オンナヘンニ ローノ ウバ
厩	キューシャノ ウマヤ
浦	サンズイ ウラワノ ウラ
瓜	ショクブツノ ウリ
閏	ウルードシノ ウルー
噂	クチニ ソンケイノ ウワサ
云	ウンヌンノ ウン
運	ハコブノ ウン
雲	ウンカイノ クモ
荏	クサカンムリニ マカセルノ エ
餌	エサノ エ
叡	ヒエイザンノ エイ
営	イトナムノ エイ
嬰	アカゴ エイジノ エイ
影	カゲノ エイ
映	ウツス エイガノ エイ
曳	エイコースルノ エイ
栄	サカエルノ エイ
永	エイキューノ エイ
泳	オヨグ スイエイノ エイ
洩	モレル ローエイノ エイ
瑛	オーヘンニ エイゴノ エイ
盈	ミチアフレルノ エイ
穎	スグレル イミノ エイ
頴	イネノ ホサキノ エイ
英	エイゴノ エイ
衛	マモルノ エイ
詠	ヨム ローエイノ エイ
鋭	スルドイノ エイ
液	エキタイノ エキ
疫	エキビョーノ エキ
益	リエキノ エキ
駅	テツドウノ エキ
悦	ヨロコブノ エツ
謁	ハイエツノ エツ
越	タクエツスルノ エツ
閲	エツランスルノ エツ
榎	キヘンニ ナツノ エノキ
厭	イトウ エンセイカンノ エン
円	マルノ エン
園	ソノ  ショクブツエンノ エン
堰	セキノ エン
奄	アマミオオシマノ アマノ エン
宴	ウタゲノ エン
延	ノバスノ エン
怨	フンエンノ エン
掩	オオウノ エン
援	エンジョノ エン
沿	ニホンカイ エンガンノ エン
演	エンゲキノ エン
炎	ヒヲ フタツカサネタ ホノオノ エン
焔	ヒヘン ホノオノ エン
煙	ケムリノ エン
燕	ワタリドリノ ツバメ
猿	エン ドーブツノ サル
縁	エンガワノ エン
艶	ツヤノ エン
苑	ソノ ギョエン コージエンノ エン
薗	ソノ クサカンムリノ エン
遠	トオイノ エン
鉛	カネヘンノ ナマリ
鴛	オシドリノ イミノ エン
塩	シオ ショクエンノ エン
於	ナニナニニ オイテノ オ
汚	オセンスルノ オ
甥	イキルニ オトコノ オイ
凹	オートツノ オー
央	チューオーノ オー
奥	オクサマノ オク
往	オーフクスルノ オー
応	オートースルノ オー
押	オシイレノ オス
旺	ショクヨク オーセイノ オー
横	タテヨコノ ヨコ
欧	ヨーロッパノ オー
殴	ナグル オーダスルノ オー
王	オオサマノ オー
翁	オキナノ オー
襖	コロモヘンニ オクノ オー
鴬	ウグイスノ オー
鴎	カモメノ オー
黄	キイロノ オー
岡	オカヤマケンノ オカ
沖	サンズイニ ナカノ オキ
荻	クサニ ケモノヘンノ オギ
億	ニンベンニ イケンノ オク
屋	オク ヤネノ ヤ
憶	キオクスルノ オク
臆	オクビョーノ オク
桶	テオケノ オケ
牡	ケモノノ オスノ イミノ オス
乙	コーオツヘイノ オツ
俺	ニンベンニ オオウノ オレ
卸	オロシドンヤノ オロシ
恩	オンガエシノ オン
温	アタタカイノ オン
穏	オダヤカノ オン
音	オトノ オン
下	ウエシタノ シタ
化	バケルノ カ
仮	カリニノ カ
何	ナニナニノ ナニ
伽	ニンベンニ クワエルノ カ
価	カカクヒョーノ カ
佳	ニンベンニ ツチフタツ カサクノ カ
加	クワエルノ カ
可	カノーセイノ カ
嘉	ヨシノ カ
夏	キセツノ ナツ
嫁	トツグノ カ
家	イエ カゾクノ カ
寡	スクナイノ カ
科	シゼンカガクノ カ
暇	キューカヲ トルノ カ
果	クダモノノ カ
架	ジュージカノ カ
歌	ウタノ カ
河	サンズイノ カワ
火	カヨービノ カ
珂	オーヘンニ ユーリョーカノ カ
禍	ワザワイノ カ
禾	イネヲ アラワス イミノ カ
稼	カセグノ カ
箇	カジョーガキノ カ
花	ハナタバノ ハナ
苛	イラダツノ カ
茄	クサカンムリニ クワエルノ カ
荷	ニモツノ ニ
華	カ ハナヤカノ ハナ
菓	オカシノ カ
蝦	エビノ イミノ カ
課	ホーカゴノ カ
嘩	クチヘンニ ハナヤカノ カ
貨	カモツノ カ
迦	シンニューニ クワエルノ カ
過	スギルノ カ
霞	カスミノ カ
蚊	ムシノ カ
俄	ニワカアメノ ニワカ
峨	ヤマヘンニ ワレノ ガ
我	ワレノ ガ
牙	キバノ ガ
画	ガカ ヘキガノ ガ
臥	フセルノ ガ
芽	メノ ガ
蛾	ムシノ ガ
賀	ネンガジョーノ ガ
雅	ミヤビヤカノ ガ
餓	キガジョータイノ ガ
駕	クワエルノ シタニ ウマノ ガ
介	カイゴスルノ カイ
会	アウ カイシャノ カイ
解	カイシャクノ カイ
回	カイランバンノ カイ
塊	カタマリノ カイ
壊	コワスノ カイ
廻	マワスノ カイ
快	ココロヨイノ カイ
怪	アヤシイノ カイ
悔	クヤムノ カイ
恢	ヒロイ イミノ カイ
懐	フトコロノ カイ
戒	イマシメノ カイ
拐	トラエルノ カイ
改	アラタメルノ カイ
魁	カシラノ カイ
晦	キヘンニ マイノ カイ
械	キヘンノ キカイノ カイ
海	ウミノ カイ
灰	ハイヲ アラワスノ カイ
界	セカイノ カイ
皆	ミンナノ カイ
絵	カイ エホンノ エ
芥	クサカンムリニ スケノ カイ
蟹	トクノシタニ ムシノ カニ
開	ヒラクノ カイ
階	カイダンノ カイ
貝	カイガラノ カイ
凱	ガイセンノ ガイ
劾	ダンガイスルノ ガイ
外	ソト ナイガイノ ガイ
咳	セキノ ガイ
害	ソンガイノ ガイ
崖	ガケ ダンガイノ ガイ
慨	キガイノ ガイ
概	オオムネノ ガイ
涯	イッショーガイノ ガイ
碍	サマタゲルノ ガイ
蓋	ガイ フタヲ スルノ フタ
街	ハンカガイノ ガイ
該	アテルノ ガイ
鎧	ヨロイノ イミノ ガイ
骸	ムクロノ ガイ
浬	サンズイニ サトノ カイリ
馨	カオルノ ケイ
蛙	ムシヘンニ ツチフタツノ カエル
垣	カキネノ カキ
柿	カキノキノ カキ
蛎	カイノ カキ
鈎	カギバリノ カギ
劃	カクイツノ カク
嚇	オドスノ カク
各	オノオノノ カク
廓	ガンダレ クルワノ カク
拡	カクダイノ カク
撹	カクハンノ カク
格	ゴーカクノ カク
核	ゲンシカクノ カク
殻	カラノ カク
獲	シューカクノ カク
確	タシカノ カク
穫	ノギヘンノ シューカクノ カク
覚	オボエルノ カク
角	ツノ カクドノ カク
赫	アカフタツノ カク
較	クラベルノ カク
郭	ジョウカク リンカクノ カク、クルワ
閣	テンシュカクノ カク
隔	ヘダテルノ カク
革	カワセイヒンノ カワ
学	マナブノ ガク
岳	サンガクノ ガク
楽	タノシムノ ガク
額	キンガクノ ガク
顎	アゴノ ガク
掛	ヨビカケルノ カ
笠	タケカンムリニ タツノ カサ
樫	キヘンニ カタイノ カシ
橿	チメイ カシハラシノ カシ
梶	キヘンニ オノ カジ
鰍	ウオヘンニ アキノ カジカ
潟	ニイガタノ ガタ
割	ブンカツノ カツ
喝	カッサイノ カツ
恰	リッシンベンニ アウノ カツ
括	テヘンニ シタノ カツ
活	セイカツスルノ カツ
渇	カワクノ カツ
滑	エンカツノ カツ
葛	チメイ カツシカクノ カツ
褐	カッショクノ カツ
轄	ショカツショノ カツ
且	セツゾクシノ カツ
鰹	ウオヘンニ カタイノ カツオ
叶	クチヘンニ ジューノ カナ
椛	キヘンニ ハナノ モミジ
樺	キヘンニ ハナヤカノ カバ
鞄	カワヘンニ ツツムノ カバン
株	カブシキガイシャノ カブ
兜	テツカブトノ カブト
竃	アナカンムリニ カメノ カマド
蒲	クサカンムリニ ウラノ ガマ
釜	カマイシノ カマ
鎌	カマクラノ カマ
噛	クチヘンニ ハノ カム
鴨	コーニトリノ カモ
栢	キヘンニ ヒャクノ カシワ
茅	クサカンムリニ ムノ カヤ
萱	クサカンムリニ センノ カヤ
粥	オカユノ カユ
刈	イネヲ カルノ カ
苅	クサカンムリ イネヲ カルノ カ
瓦	ヤネガワラノ カワラ
乾	カワクノ カン
侃	ツヨイトイウイミノ カン
冠	カンムリノ カン
寒	サムイノ カン
刊	チョーカンユーカンノ カン
勘	カンベンスルノ カン
勧	ススメルノ カン
巻	マキモノノ カン
喚	ヨブノ カン
堪	タエルノ カン
姦	カシマシ カンツーノ カン
完	カンセイスルノ カン
官	ケイサツカンノ カン
寛	ヒロイノ カン
干	ホスノ カン
幹	ミキノ カン
患	ワズラウノ カン
感	カンジルノ カン
慣	ナレルノ カン
憾	イカンノ カン
換	コーカンスルノ カン
敢	アエテノ カン
柑	キヘンニ アマイノ カン
桓	キヘンニ ワタルノ カン
棺	カンオケノ カン
款	マコトノ カン
歓	カンゲイスルノ カン
汗	アセノ カン
漢	トーヨーカンジノ カン
澗	カンスイノ カン
潅	ソソグノ カン
環	カンキョーノ カン
甘	アマイノ カン
監	カントクノ カン
看	カンゴフノ カン
竿	サオノ カン
管	クダノ カン
簡	カンタンノ カン
緩	ユルヤカノ カン
缶	カンズメノ カン
翰	ショカンノ カン
肝	カンゾーノ カン
艦	センスイカンノ カン
莞	クサカンムリニ カンノ カン
観	カンサツスルノ カン
諌	イサメルノ カン
貫	ツラヌクノ カン
還	キカンスルノ カン
鑑	カガミノ イミノ カン
間	アイダノ カン
閑	サビシイノ カン
関	カカワルノ カン
陥	オチイルノ カン
韓	カンコク コクメイノ カン
館	ヤカタノ カン
舘	ヤカタノ ゾクジノ カン
丸	ガン エンケイノ マル
含	フクムノ ガン
岸	キシ ガンペキノ ガン
巌	イワオ ガンクツオーノ ガン
玩	ガングノ ガン
癌	ガンサイボーノ ガン
眼	マナコ メノ ガン
岩	イワノ ガン
翫	モテアソブノ ガン
贋	ニセモノノ ガン
雁	ワタリドリノ ガン
頑	ガンバルノ ガン
顔	カオ ガンメンノ ガン
願	ネガイノ ガン
企	クワダテルノ キ
伎	ニンベンニ ササエルノ キ
危	アヤウイノ キ
喜	ヨロコブノ キ
器	ウツワノ キ
基	モト キソノ キ
奇	キスーグースーノ キ
嬉	オンナヘンニ ヨロコブノ キ
寄	ヨセルノ キ
岐	ヤマヘンニ ササエルノ キ
希	ネガウノ キ
幾	キカガクノ キ
忌	オノレノシタニココロノ キ
揮	フルウノ キ
机	ツクエノ キ
旗	ハタノ キ
既	スデニノ キ
期	イッテイキカンノ キ
棋	ショーギノ ギ
棄	ステルノ キ
機	キヘン キカイノ キ
帰	カエルノ キ
毅	ツヨシノ キ
気	クーキノ キ
汽	キセンノ キ
畿	キンキチホーノ キ
祈	イノルノ キ
季	キセツノ キ
稀	マレ キショーカチノ キ
紀	ニジュッセイキノ キ
徽	シルシノ キ
規	キソクノ キ
記	シルス キロクノ キ
貴	トートイ キキンゾクノ キ
起	オキルノ キ
軌	キドーシューセイノ キ
輝	カガヤクノ キ
飢	キガジョータイノ キ
騎	キバセンノ キ
鬼	キ オニノ キ
亀	ツルカメノ カメ
偽	ギ ニセモノノ ニセ
儀	ギシキノ ギ
妓	オンナヘンニ ササエルノ ギ
宜	テキギノ ギ
戯	タワムレルノ ギ
技	ワザノ ギ
擬	モギシケンノ ギ
欺	アザムクノ ギ
犠	ギセイノ ギ
疑	ウタガウノ ギ
祇	キョートノ ギオンノ ギ
義	ギムノ ギ
蟻	ギ ムシノ アリ
誼	ゴコーギヲ タマワルノ ギ
議	ギロンノ ギ
掬	スクーノ キク
菊	ハナノ キク
鞠	ケマリノ キク
吉	キチジツノ キチ
吃	ドモリノ キツ
喫	キッサテンノ キツ
桔	ショクブツノキキョーノ キツ
橘	ハナノ タチバナノ キツ
詰	キツモンスルノ キツ
砧	イシヘンニ ウラナウノ キヌタ
杵	キヘンニ ゴノ キネ
黍	サトーキビノ キビ
却	シリゾクノ キャク
客	オキャクサマノ キャク
脚	キャクホンノ キャク
虐	シイタゲルノ ギャク
逆	サカラウノ ギャク
丘	オカ サキューノ キュー
久	ヒサシイノ キュー
仇	アダウチノ アダ
休	ヤスムノ キュー
及	キューダイノ キュー
吸	スー コキューノ キュー
宮	キューデンノ キュウ
弓	ユミ キュードーノ キュー
急	イソグノ キュー
救	スクーノ キュー
朽	ローキューカノ キュー
求	モトメルノ キュー
汲	ミズヲ クムノ クム
泣	ナクノ キュー
灸	ハリキューノ キュー
球	タマノ キュー
究	キワメルノ キュー
窮	キューキョクノ キュー
笈	オイノ キュー
級	ガッキューノ キュー
糾	タダスノ キュー
給	キューキンノ キュー
旧	フルイノ キュー
牛	ウシノ ギュー
去	キョネンノ キョ
居	ジューキョノ キョ
巨	キョジンノ キョ
拒	コバムノ キョ
拠	コンキョノ キョ
挙	アゲルノ キョ
渠	ミゾノ キョ
虚	ウツロノ キョ
許	ユルスノ キョ
距	キョリノ キョ
鋸	ノコギリノ キョ
漁	ギョギョーノ ギョ
禦	フセグノ ギョ
魚	サカナ ギョルイノ ギョ
亨	コー ジンメイノ トオル
享	ウケルノ キョー
京	キョートノ キョー
供	ソナエルノ キョー
侠	ニンキョーノ キョー
僑	カキョーノ キョー
兇	オソレルノ キョー
競	キソーノ キョー
共	ドチラトモニノ トモ
凶	キッキョーノ キョー
協	キョーリョクスルノ キョー
匡	タダスノ キョー
卿	ケイショー サー ノ キョー
叫	サケブ ゼッキョーノ キョー
喬	タカイノ キョー
境	コッキョーノ キョー
峡	キョーコクノ キョー
強	ツヨイノ キョー
彊	ジギョージュツノ キョー
怯	オビエルノ キョー
恐	キョーフノ キョー
恭	ウヤウヤシイノ キョー
挟	ハサムノ キョー
教	オシエルノ キョー
橋	ハシノ キョー
況	フキョーノ キョー
狂	クルウノ キョー
狭	セマイノ キョー
矯	タメルノ キョー
胸	ムネノ キョー
脅	オドスノ キョー
興	キョーミノ キョー
蕎	クサカンムリニ タカイノ キョー
郷	キョーリノ キョー
鏡	カガミノ キョー
響	ヒビクノ キョー
饗	モテナスノ キョー
驚	オドロクノ キョー
仰	アオグノ ギョー
凝	コルノ ギョー
尭	タカイノ ギョー
暁	アカツキノ ギョー
業	ジュギョーノ ギョー
局	ユービンキョクノ キョク
曲	ワンキョクスルノ キョク
極	ホッキョクノ キョク
玉	タマノ ギョク
桐	キヘンニ オナジノ キリ
粁	キョリノ キロメートル
僅	ワズカノ キン
勤	ツトメルノ キン
均	ヒトシイノ キン
巾	ハバノ キン
錦	ニシキノ キン
斤	オノヅクリ イッキン ニキンノ キン
欣	ヨロコブノ キン
欽	ツツシムノ キン
琴	コトノ キン
禁	キンシスルノ キン
禽	キンジューノ キン
筋	キンニクノ キン
緊	キンチョーノ キン
芹	セリノ キン
菌	バイキンノ キン
衿	コロモヘン カイキンシャツノ エリ
襟	コロモヘン エリモトノ エリ
謹	ツツシム キンガ シンネンノ キン
近	チカイノ キン
金	カネ キンゾクノ キン
吟	ギンユーノ ギン
銀	キンギンノ ギン
九	カンスージノ キュー
倶	トモニ クラブノ ク
句	ハイクノ ク
区	クギルノ ク
狗	テングノ ク
玖	オーヘンニ ヒサシイノ ク
矩	ノリノ ク
苦	クルシイノ ク
躯	カラダノ ク
駆	ウマヘンニ クギルノ ク
駈	ウマヘンニ オカノ ク
駒	ウマヘンニ ハイクノクノ ク
具	ドーグノ グ
愚	オロカノ グ
虞	オソレノ グ
喰	クチヘンニ タベルノ クー
空	ソラ クーキノ クー
偶	タマタマノ グー
寓	グーワノ グー
遇	アウノ グー
隅	スミノ グー
串	クシザシノ クシ
櫛	キヘンニ キセツノ セツノ クシ
釧	チレイ クシロシノ クシ
屑	クズカゴノ クズ
屈	クツジョクノ クツ
掘	ホルノ クツ
窟	ドークツノ クツ
沓	ミズノシタニ ヒノ クツ
靴	カワヘンニ バケルノ クツ
轡	ウマノ クツワ
窪	クボチノ クボ
熊	ドーブツノ クマ
隈	コザトヘンニ オソレルノ クマ
粂	ヒサシイニ コメノ クメ
栗	クリノキノ クリ
繰	クリカエシノ クリ
桑	クワノキノ クワ
鍬	ノーキグノ クワ
勲	クンショーノ クン
君	キミ ショクンノ クン
薫	カオルノ クン
訓	クンレンノ クン
群	ムレ グンシューノ グン
軍	グンタイノ グン
郡	コオリ ナニナニグンノ グン
卦	ハッケノ ケ
袈	クワエルニ コロモノ ケ
祁	シメスヘンニ オオザトノ ケ
係	カンケイノ ケイ
傾	カタムクノ ケイ
刑	ケイホーノ ケイ
兄	アニ オトートノ アニ
啓	ヒラク ハイケイノ ケイ
圭	ツチフタツノ ケイ
珪	オーヘンニ ツチフタツノ ケイ
型	ケイ ケツエキガタノ ガタ
契	チギリノ ケイ
形	カタチノ ケイ
径	チョッケイ ハンケイノ ケイ
恵	メグムノ ケイ
慶	ヨロコブノ ケイ
慧	サトイノ ケイ
憩	キューケイスルノ ケイ
掲	カカゲルノ ケイ
携	タズサエルノ ケイ
敬	ウヤマウノ ケイ
景	ケシキノ ケイ
桂	カツラノ ケイ
渓	ケイコクノ ケイ
畦	タニ ツチフタツノ ケイ
稽	ケイコスルノ ケイ
系	ケイトーノ ケイ
経	ケイザイガクノ ケイ
継	ケイショースルノ ケイ
繋	ツナグノ ケイ
罫	ケイセンノ ケイ
茎	クキ チカケイノ ケイ
荊	イバラノ ケイ
蛍	ホタルノ ケイ
計	ハカルノ ケイ
詣	モーデルノ ケイ
警	ケイサツノ ケイ
軽	カルイノ ケイ
頚	クビノ ケイ
鶏	トリノ ケイ
芸	ゲイジュツノ ゲイ
迎	ムカエルノ ゲイ
鯨	クジラノ ゲイ
劇	エンゲキノ ゲキ
戟	シゲキノ ゲキ
撃	ウツノ ゲキ
激	ハゲシイノ ゲキ
隙	スキマノ ゲキ
桁	キヘンニ ユクノ ケタ
傑	ゴーケツノ ケツ
欠	ケッセキノ ケツ
決	キマルノ ケツ
潔	セイケツノ ケツ
穴	アナホリノ アナ
結	ムスブノ ケツ
血	ケツエキノ ケツ
訣	ワカレルノ ケツ
月	ニクヅキ ゲツヨーノ ツキ
件	ジケンノ ケン
倹	ケンヤクノ ケン
倦	ツカレルノ ケン
健	ケンコーノ ケン
兼	カネルノ ケン
券	ニュージョーケンノ ケン
剣	ツルギノ ケン
喧	ケンカスルノ ケン
圏	ハンイヲ アラワス イミノ ケン
堅	カタイノ ケン
嫌	キラウノ ケン
建	タテルノ ケン
憲	ケンポーノ ケン
懸	イッショケンメイノ ケン
拳	タイキョクケンノ ケン
捲	ケンド ジューライノ ケン
検	ケンサスルノ ケン
権	ケンリノ ケン
牽	ケンインノ ケン
犬	ドーブツノ イヌ
献	タテマツルノ ケン
研	ケンキュースルノ ケン
硯	スズリバコノ スズリ
絹	キヌオリモノノ キヌ
県	ナニナニケンノ ケン
肩	カタコリノ カタ
見	ミル ケンガクノ ケン
謙	ケンジョーゴノ ケン
賢	カシコイノ ケン
軒	イエノ ケンスーノ ケン
遣	ハケンスルノ ケン
鍵	カギヲ カケルノ カギ
険	ケワシイノ ケン
顕	ケンビキョーノ ケン
験	ジッケンスルノ ケン
鹸	セッケンノ ケン
元	ゲン モトノカタチノ モト
原	ハラ ソーゲンノ ゲン
厳	キビシイ ゲンカクノ ゲン
幻	マボロシ ゲンエイノ ゲン
弦	ツル ゲンガッキノ ゲン
減	ゲンショースルノ ゲン
源	ミナモトノ ゲン
玄	ゲンマイノ ゲン
現	アラワレルノ ゲン
絃	イト コト サンゲンノ ゲン
舷	フナバタノ ゲン
言	ゲンゴガクノ ゲン
諺	コトワザノ ゲン
限	モンゲンノ ゲン
乎	ダンコトシテノ コ
個	コジンシュギノ コ
古	フルイノ コ
呼	コキュースルノ コ
固	コケイブツノ コ
姑	シュートメノ コ
孤	コドクノ コ
己	オノレノ コ
庫	シャコノ コ
弧	カッコノ コ
戸	コベツホーモンノ コ
故	コキョーノ コ
枯	カレルノ コ
湖	ミズウミノ コ
狐	ケモノヘンニ ウリノ キツネ
糊	センタクノリノ ノリ
袴	ハオリ ハカマノ ハカマ
股	フタマタ コカンセツノ コ
胡	エビスノ コ
菰	コモカブリノ コモ
虎	ドーブツノ トラ
誇	コチョースルノ コ
跨	マタグノ コ
鈷	カネヘンニ フルイノ コ
雇	ヤトウ コヨースルノ コ
顧	カエリミルノ コ
鼓	タイコノ コ
五	カンスージノ ゴ
互	ソーゴカンケイノ ゴ
伍	ラクゴスルノ ゴ
午	ゴゼン ゴゴノ ゴ
呉	ゴフクノ ゴ
吾	ワレノ ゴ
娯	ゴラクノ ゴ
後	ウシロノ ゴ
御	オン ゴショノ ゴ
悟	カクゴスルノ ゴ
梧	アオギリノ ゴ
檎	リンゴノ ゴ
瑚	サンゴショーノ ゴ
碁	ゴイシノ ゴ
語	ゲンゴノ ゴ
誤	ゴカイノ ゴ
護	マモルノ ゴ
醐	ダイゴミガ アルノ ゴ
乞	コジキノ コ
鯉	サカナノ コイ
交	マジワルノ コー
佼	ニンベンニ マジワルノ コー
侯	オーコーキゾクノ コー
候	テンコーチョーサノ コー
倖	ニンベンニ サイワイノ コー
光	ヒカルノ コー
公	オオヤケノ コー
功	コーローシャノ コー
効	キキメノ コー
勾	キューコーバイノ コー
厚	アツイノ コー
口	デイリグチノ コー
向	ムカウノ コー
后	キサキノ コー
喉	ノドノ コー
坑	アナ タンコーノ コー
垢	テアカガ ツクノ アカ
好	ドーコーカイノ コー
孔	アナ コーシノ コー
孝	オヤコーコーノ コー
宏	ナマエ ウカンムリノ ヒロシ
工	タクミ コーサクノ コー
巧	タクミ ギコーノ コー
巷	チマタノ コー
幸	サイワイノ コー
広	ヒロイ コーハンイノ コー
庚	コーシンヅカノ コー
康	ケンコーノ コー
弘	ヒロ ユミヘンノ コー
恒	コーキューテキノ コー
慌	アワタダシイノ コー
抗	アラガウ テイコーノ コー
拘	コーソクスルノ コー
控	キソコージョノ コー
攻	セメルノ コー
昂	タカメル イキケンコーノ コー
晃	ジンメイ アキラノ コー
更	サラニ コーイシツノ コー
杭	クイヲ ウツノ クイ
校	ガッコーノ コー
梗	キキョーノ ハナノ キョー
構	カマエルノ コー
江	エドジダイノ エ
洪	コーズイノ コー
浩	ヒロシ サンズイニ ツゲルノ コー
港	ミナト クーコーノ コー
溝	ミゾノ コー
甲	コーオツヘイノ コー
皇	コータイシノ コー
硬	カタイ ドーミャクコーカノ コー
稿	ゲンコーヨーシノ コー
糠	ヌカ コメヘンニ ケンコーノ コー
紅	ベニ コーハクノ コー
紘	イトヘン ハッコー イチウノ コー
絞	シボル コーシュケイノ コー
綱	コー ツナヒキノ ツナ
耕	タガヤス ノーコーチノ コー
考	カンガエルノ コー
肯	コーテイテキノ コー
肱	ヒジノ コー
腔	ニクヅキニ ソラノ クー
膏	コーヤクヲ ヌルノ コー
航	ウミヲ ワタルコーカイノ コー
荒	アレルノ コー
行	ギョーレツノ ギョー
衡	ハカルノ コー
講	コーザノ コー
貢	ミツグ コーケンノ コー
購	コーニュースルノ コー
郊	マチノ コーガイノ コー
酵	コーボキンノ コー
鉱	テッコーセキノ コー
砿	アラガネノ コー
鋼	ハガネ コーテツノ コー
閤	タイコー ヒデヨシノ コー
降	フル コースイリョーノ コー
項	ウナジ コーモクノ コー
香	カオリノ コー
高	タカイノ コー
鴻	オオトリノ コー
剛	シツジツ ゴーケンノ ゴー
劫	ジゴクノ ゴーカノ ゴー
号	バンゴーノ ゴー
合	アウ ゴーカクスルノ ゴー
壕	ザンゴー ボークーゴーノ ゴー
拷	ゴーモンスルノ ゴー
濠	ミゾジョーノ アナノ ゴー
豪	ゴーケツノ ゴー
轟	トドロクノ ゴー
麹	コメコージノ コージ
克	コクフクノ コク
刻	キザム ジコクノ コク
告	ツゲル ホーコクノ コク
国	クニ コクミンノ コク
穀	コクモツノ コク
酷	ザンコクノ コク
鵠	ツゲルニ トリノ コク
黒	イロ クロノ コク
獄	ジゴクノ ゴク
漉	ウラゴシノ コシ
腰	コシボネノ コシ
甑	コシキジマノ コシキ
忽	コツゼント アラワレルノ コツ
惚	コーコツ ジョータイノ コツ
骨	コツズイノ コツ
狛	コマイヌノ コマ
込	モジノ カキコミノ コミ
此	トマルニ カタカナノ ヒノ コノ
頃	コロアイノ コロ
今	イマ ムカシノ イマ
困	コマル コンナンノ コン
坤	ツチヘンニ モースノ コン
墾	カイコンチノ コン
婚	ケッコンシキノ コン
恨	ウラム エンコンノ コン
懇	コンダンカイノ コン
昏	コンスイ ジョータイノ コン
昆	コンチューノ コン
根	ネ コンポンノ コン
梱	ツツム コンポーノ コン
混	マジル コンランノ コン
痕	アト コンセキノ コン
紺	コンイロノ コン
艮	ホーガクノ ウシトラノ コン
魂	タマシイ レイコンノ コン
些	イササカノ サ
佐	タスケ ホサヤクノ サ
叉	サンサ シンケイノ サ
唆	ソソノカス シサスルノ サ
嵯	キョートノ サガノノ サ
左	ミギヒダリノ ヒダリ
差	サベツスルノ サ
査	ケンサノ サ
沙	サンズイニ スクナイノ サ
瑳	ミガクノ サ
砂	スナ サバクノ サ
詐	サギノ サ
鎖	クサリ レンサハンノーノ サ
裟	コロモノ ケサノ サ
坐	スワルノ ザ
座	スワル ザセキノ ザ
挫	クジク ネンザノ ザ
債	フサイヲ オウノ サイ
催	モヨオス シュサイシャノ サイ
再	フタタビ サイドノ サイ
最	モットモ サイショノ サイ
哉	カイサイヲ サケブノ サイ
塞	トリデ ヨーサイノ サイ
妻	ツマ サイシノ サイ
宰	ソーリノ サイショーノ サイ
彩	イロドリ サイシキノ サイ
才	サイノーノ サイ
採	トル サイヨーノ サイ
栽	サイバイスルノ サイ
歳	サイゲツノ サイ
済	ヘンサイスルノ サイ
災	ワザワイ サイナンノ サイ
采	サイハイヲ フルウノ サイ
犀	ドーブツノ サイ
砕	クダク フンサイノ サイ
砦	トリデ ヨーサイノ サイ
祭	マツリ サイジツノ サイ
斎	ショサイノ サイ
細	ホソイ サイボーノ サイ
菜	ヤサイノ サイ
裁	サイバンカンノ サイ
載	レンサイ ショーセツノ サイ
際	キワ サイゲンナクノ サイ
剤	ヤクザイシノ ザイ
在	ソンザイスルノ ザイ
材	ザイリョーノ ザイ
罪	ツミ ザイアクノ ザイ
財	ザイサンノ ザイ
冴	サエルノ サエ
坂	サカミチノ サカ
阪	オオサカシノ サカ
堺	サカイシノ サカイ
榊	キヘンニ カミノ サカキ
肴	サケノ サカナノ サカナ
咲	ハナガ サクノ サク
崎	タカサキシノ サキ
埼	サキ:サイタマケンノ サイ
碕	イシヘンニ キノ サキ
鷺	トリノ サギ
作	ツクル サクヒンノ サク
削	ケズル サクジョノ サク
咋	クチヘンニ ナガラノ クー
搾	シボル サクシュノ サク
昨	サクネンノ サク
朔	ツイタチノ サク
柵	カコイノ サク
窄	セマイ キョーサクノ サク
策	サクリャクノ サク
索	サクインノ サク
錯	サッカクノ サク
桜	ハナノ サクラ
鮭	サカナノ サケ
笹	ショクブツノ ササ
匙	サジカゲンノ サジ
冊	ホンノ サツスーノ サツ
刷	インサツノ サツ
察	カンサツスルノ サツ
拶	アイサツノ サツ
撮	トル サツエイスルノ サツ
擦	マサツノ サツ
札	サツタバノ サツ
殺	サツジンノ サツ
薩	ボサツノ サツ
雑	ザツオンノ ザツ
皐	ショクブツノ サツキ
鯖	サカナノ サバ
捌	ウリサバクノ サバ
錆	テツサビノ サビ
鮫	サメハダノ サメ
皿	ハイザラノ サラ
晒	サラシモメンノ サラシ
三	カンスージノ サン
傘	カサ ラッカサンノ サン
参	サンコーショノ サン
山	ヤマ サンミャクノ サン
惨	ヒサンノ サン
撒	マク サンプスルノ サン
散	チル サンポミチノ サン
桟	サンバシノ サン
燦	アキラカノ サン
珊	サンゴショーノ サン
産	ウム シュッサンノ サン
算	サンスーノ サン
纂	アツメルノ サン
蚕	カイコ ヨーサンノ サン
讃	タタエルノ サン
賛	サンセイスルノ サン
酸	サン アルカリノ サン
餐	バンサンノ サン
斬	ザンサツノ ザン
暫	シバラクノ ザン
残	ノコルノ ザン
仕	シゴトノ シ
仔	ニンベンニ コドモノ コ
伺	ウカガウノ シ
使	ツカウノ シ
刺	シゲキノ シ
司	シカイシャノ シ
史	レキシノ シ
嗣	ツグノ シ
四	カンスージノ ヨン
士	サムライノ シ
始	ハジメルノ シ
姉	アネ シマイノ アネ
姿	スガタ カタチノ スガタ
子	コドモノ コ
屍	シカバネノ シ
市	シチョーソンノ シ
師	キョーシノ シ
志	ココロザスノ シ
思	オモウノ シ
指	ユビノ シ
支	ササエルノ シ
孜	ツトメルノ シ
斯	シカイノ ケンイシャノ ス
施	ホドコスノ シ
旨	ムネ ヨーシヲ マトメルノ シ
枝	エダノ シ
止	トメル キンシノ シ
死	シヌノ シ
氏	ジューショ シメイノ シ
獅	ライオンヲ イミスルシシノ シ
祉	シャカイフクシノ シ
私	ワタクシノ シ
糸	キヌイトノ イト
紙	カミ シヘイノ シ
紫	ムラサキ シガイセンノ シ
肢	ジョーシノ シ
脂	シ ヒカシボーノ アブラ
至	イタル ゲシノ シ
視	ミル シリョクノ シ
詞	コトバ サクシノ シ
詩	シイカノ シ
試	ココロミル シケンノ シ
誌	ザッシノ シ
諮	ハカル シモンスルノ シ
資	シホンキンノ シ
賜	タマモノノ シ
雌	オスメスノ メス
飼	シイクスルノ シ
歯	ハノ シ
事	コト ジケンノ ジ
似	ルイジスルノ ジ
侍	ジジューノ ジ
児	ジドー セイトノ ジ
字	モジノ ジ
寺	テラノ ジ
慈	イツクシムノ ジ
持	モツノ ジ
時	ジカンノ ジ
次	ツギ ジカイノ ジ
滋	シガケンノ シ
治	オサメルノ ジ
爾	カンジノ ジ
璽	シルシノ ジ
痔	ヤマイダレニ テラノ ジ
磁	ジシャクノ ジ
示	シメスノ ジ
而	ケイジジョーノ ジ
耳	ジビカノ ミミ
自	ジブンノ ジ
蒔	クサカンムリニ トキノ ジ
辞	コクゴジショノ ジ
汐	チョーセキノ シオ
鹿	ドーブツノ シカ
式	ケッコンシキノ シキ
識	シキベツスルノ シキ
鴫	トリノ シギ
竺	カラ テンジクノ ジク
軸	シャジクノ ジク
宍	ウカンムリニ ロクノ シシ
雫	アメカンムリニ シタノ シズク
七	カンスージノ シチ
叱	シカルノ シツ
執	シッピツノ シツ
失	ウシナウノ シツ
嫉	シットスルノ シツ
室	キョーシツノ シツ
悉	コトゴトクノ シツ
湿	シッチタイノ シツ
漆	ウルシ シッキノ シツ
疾	シッペイノ シツ
質	シツモンノ シツ
実	カジツノ ジツ
蔀	クサカンムリニ ブノ シトミ
篠	シノブエノ シノ
偲	シノブノ シノ
柴	コレノ シタニ キノ シバ
芝	シバフノ シバ
屡	シバシバノ シバ
蕊	メシベ オシベノ シベ
縞	イトヘンニ タカイノ シマ
舎	キシュクシャノ シャ
写	シャシンノ シャ
射	ホーシャセンノ シャ
捨	シュシャ センタクノ シャ
赦	オンシャノ シャ
斜	ナナメ シャメンノ シャ
煮	シャフツ ショードクノ シャ
社	シャカイノ シャ
紗	ヌノノ シャ
者	モノ ガクシャノ シャ
謝	シャザイスルノ シャ
車	クルマノ シャ
遮	サエギル シャダンノ シャ
蛇	ヘビ ジャバラノ ジャ
邪	ヨコシマ ジャアクノ ジャ
借	シャクヨースルノ シャク
勺	イチゴー ゴシャクノ シャク
尺	シャッカンホーノ シャク
杓	ヒシャクノ シャク
灼	シャクネツノ シャク
爵	ハクシャクノ シャク
酌	サケノ バンシャクノ シャク
釈	シャクメイスルノ シャク
錫	ズスノ シャク
若	ジャクネンシャノ ジャク
寂	セイジャクノ ジャク
弱	キョージャクノ ジャク
惹	ジャッキスルノ ジャク
主	アルジノ シュ
取	サイシュスルノ シュ
守	マモル シュエイノ シュ
手	テアシノ シュ
朱	シュヒツノ シュ
殊	シュクンショーノ シュ
狩	カリ シュリョーノ シュ
珠	タマ シュザンノ シュ
種	タネ シュルイノ シュ
腫	ハレル シュヨーノ シュ
趣	オモムキ シュミノ シュ
酒	オサケノ シュ
首	エリクビノ シュ
儒	ジュキョーノ ジュ
受	ウケルノ ジュ
呪	マジナイ ジュジュツノ ジュ
寿	コトブキノ ジュ
授	ジュギョーノ ジュ
樹	ネッタイ ジュリンノ ジュ
綬	イトヘンニ ウケルノ ジュ
需	モトメル ジュヨーノ ジュ
囚	シュージンノ シュー
収	シューエキノ シュー
周	シューヘンノ シュー
宗	シューキョーノ シュー
就	シューショクノ シュー
州	カワノ ナカスノ ス
修	オサメル ヒッシューノ シュー
愁	ウレウ リョシューノ シュー
拾	シュートクブツノ シュー
洲	シュー カワノ ナカスノ ス
秀	ユーシューノ シュー
秋	キセツノ アキノ シュー
終	オワリノ シュー
繍	シシューノ シュー
習	ナラウ ガクシューノ シュー
臭	ニオイ アクシューノ シュー
舟	フネノ シュー
蒐	アツメル クサカンムリ シューシュウノ シュー
衆	ガッシューコクノ シュー
襲	オソウ シューゲキノ シュー
讐	フクシュースルノ シュー
蹴	ケル イッシュースルノ シュー
輯	アツメル クルマヘン ヘンシューノ シュー
週	イッシューカンノ シュー
酋	シューチョーノ シュー
酬	ムクイル ホーシューノ シュー
集	アツメルノ シュー
醜	ミニクイ シューアクノ シュー
什	カクノ ジュー
住	スム ジューキョノ ジュー
充	アテルノ ジュー
十	カンスージノ ジュー
従	シタガウノ ジュー
戎	ホコカマエ エビスノ ジュー
柔	ジューナンノ ジュー
汁	シルノ ジュー
渋	シブイノ ジュー
獣	ケモノノ ジュー
縦	タテヨコノ タテ
重	オモイ カサネルノ ジュー
銃	ケンジューノ ジュー
叔	オジ オバノ シュク
夙	ハヤイノ イミノ シュク
宿	シュクハクスルノ シュク
淑	シュクジョノ シュク
祝	イワウ シュクエンノ シュク
縮	チヂメルノ シュク
粛	セイシュクノ シュク
塾	ガクシュージュクノ ジュク
熟	セイジュクスルノ ジュク
出	デル シュッパツノ シュツ
術	スベ ギジュツノ ジュツ
述	ノベルノ ジュツ
俊	サトシ シュンビンノ シュン
峻	シュンレツナノ シュン
春	キセツノ ハルノ シュン
瞬	シュンカンノ シュン
竣	シュンコーシキノ シュン
舜	チューゴクノ ナマエノ シュン
駿	ウマヘンノ シュンメノ シュン
准	ナゾラエル ヒジュンスルノ ジュン
循	ジュンカンスルノ ジュン
旬	ゲジュンノ ジュン
楯	タテデ フセグノ タテ
殉	ジュンキョーシャノ ジュン
淳	ジンメイ アツシノ ジュン
準	ジュンビスルノ ジュン
潤	ウルオウノ ジュン
盾	タテ ムジュンノ ジュン
純	ジュンスイノ ジュン
巡	ジュンサノ ジュン
遵	マモルノ ジュン
醇	ホージュンノ ジュン
順	ジュンバンノ ジュン
処	ショバツノ ショ
初	ハジメ サイショノ ショ
所	バショノ ショ
暑	アツイ ヒショチノ ショ
曙	アケボノノ ショ
渚	ナミウチギワノ ナギサ
庶	ショミンノ ショ
緒	ジョーチョノ チョ
署	ケイサツショチョーノ ショ
書	ショルイノ ショ
薯	イモノ ショ
藷	イモノ ショ
諸	モロモロ ショクンノ ショ
助	タスケルノ ジョ
叙	ジョジシノ ジョ
女	オンナ ジョセイノ ジョ
序	ジュンジョノ ジョ
徐	ジョコーノ ジョ
恕	ユルス ユージョノ ジョ
鋤	スキト クワノ スキ
除	ジョガイスルノ ジョ
傷	キズノ ショー
償	ツグナウノ ショー
勝	カツ ユーショースルノ ショー
匠	タクミ キョショーノ ショー
升	イッショービンノ ショー
召	オーショーノ ショー
哨	ミハリノ ショー
商	アキナイノ ショー
唱	ガッショーノ ショー
嘗	カツテノ ショー
奨	ショーレイノ ショー
妾	メカケノ ショー
娼	アソビメノ ショー
宵	シュンショーノ ショー
将	ショーライノ ショー
小	チイサイノ ショー
少	スクナイノ ショー
尚	ナオサラノ ナオ
庄	ショーヤノ ショー
床	ショー ユカシタノ ユカ
廠	シゴトバノ イミノ ショー
彰	アキラカノ ショー
承	ウケタマワルノ ショー
抄	コセキショーホンノ ショー
招	マネクノ ショー
掌	ショーアクスルノ ショー
捷	ビンショーノ ショー
昇	ノボルノ ショー
昌	ハンジョースルノ ショー
昭	アキラ ショーワノ ショー
晶	ケッショーノ ショー
松	マツノキノ マツ
梢	コヅエノ ショー
樟	ショーノーノ ショー
樵	キコリノ ショー
沼	イケ ヌマノ ヌマ
消	ケスノ ショー
渉	ワタルノ ショー
湘	ショーナンチホーノ ショー
焼	ヤクノ ショー
焦	コゲルノ ショー
照	テラスノ ショー
症	コーイショーノ ショー
省	カエリミルノ ショー
硝	ショーサンノ ショー
礁	フネガ ザショースル ノ ショー
祥	メデタイ イミノ ショー
称	トナエルノ ショー
章	ブンショーノ ショー
笑	ワラウノ ショー
粧	ヨソオウノ ショー
紹	ショーカイスルノ ショー
肖	ショーゾーノ ショー
菖	ハナショーブノ ショー
蒋	ジンメイ ショーカイセキノ ショー
蕉	バショーノ ショー
衝	ショートツノ ショー
裳	チマ モスソノ ショー
訟	ソショーノ ショー
証	アカシノ ショー
詔	ミコトノリノ ショー
詳	クワシイ ショーサイノ ショー
象	ショーチョーテキノ ショー
賞	ホメル ショーバツノ ショー
醤	ショーユノ ショー
鉦	ガッキノ カネノ ショー
鍾	ショーニュードーノ ショー
鐘	カネ ボンショーノ ショー
障	ショーガイシャノ ショー
鞘	サヤノ ショー
上	ウエノ ジョー
丈	ジョーブノ ジョー
丞	ジンメイノ ジョー
乗	ノセルノ ジョー
冗	ジョーダンノ ジョー
剰	ヨジョーノ ジョー
城	シロノ ジョー
場	バノ ジョー
壌	ドジョーノ ジョー
嬢	レイジョーノ ジョー
常	ツネノ ジョー
情	ナサケノ ジョー
擾	ミダレルノ ジョー
条	ジョーケンノ ジョー
杖	マツバヅエノ ツエ
浄	キヨメルノ ジョー
状	ジョータイノ ジョー
畳	タタミノ ジョー
穣	ユタカノ ジョー
蒸	ムスノ ジョー
譲	ユズルノ ジョー
醸	ジョーゾーノ ジョー
錠	ナンキンジョーノ ジョー
嘱	ユダネルノ ショク
埴	ハニワノノ ショク
飾	カザルノ ショク
拭	ヌグウノ ショク
植	ショクブツノ ショク
殖	フヤスノ ショク
燭	トモシビノ ショク
織	オル ショッキノ ショク
職	ショクギョーノ ショク
色	イロ シキサイノ ショク
触	フレルノ ショク
食	タベルノ ショク
蝕	ムシバムノ ショク
辱	ハズカシイノ ジョク
尻	シリオシノ シリ
伸	ノバスノ シン
信	シンヨーノ シン
侵	オカス シンニューノ シン
唇	クチビルノ シン
娠	ニンシンノ シン
寝	ネル シンシツノ シン
審	シンサノ シン
心	ココロノ シン
慎	ツツシムノ シン
振	フル サンシンノ シン
新	アタラシイノ シン
晋	ジンメイ ススムノ シン
森	シンリンノ モリ
榛	ハリ ハルナサンノ シン
浸	ヒタス シンスイノ シン
深	フカイノ シン
申	モース シンコクスルノ シン
疹	シッシンノ シン
真	マコトノ シン
神	カミサマ ノカミ シンケイノ シン
秦	ハタショーチョーノ ハタ
紳	シンシシュクジョノ シン
臣	ケライ シンカノ シン
芯	エンピツノシンノ シン
薪	タキギノ シン
親	オヤ リョーシンノ シン
診	シンサツノ シン
身	シンタイケンサノ シン
辛	カライ コーシンリョーノ シン
進	ススム シンポノ シン
針	ヌイモノバリノ ハリ
震	フルエル ジシンノ シン
人	ヒト ジンルイノ ジン
仁	イワジンジュツノ ジン
刃	ヤイバノ ジン
塵	チリノ ジン
壬	ミズノエノ ジン
尋	タズネルノ ジン
甚	ハナハダシイノ ジン
尽	ツクスノ ジン
腎	ジンゾーノ ジン
訊	ジンモンスルノ ジン
迅	ハヤイ ジンソクノ ジン
陣	ホンジンノ ジン
靭	ジンタイソンショーノ ジン
笥	タンスノ ス
諏	スワコノ ス
須	ヒッスジコーノ ス
酢	スジョーユノ ス
図	セッケイズノ ズ
厨	タマムシノズシノ ズ
逗	シンニューニノ ズ
吹	スイソーガクノ スイ
垂	スイチョクノ スイ
帥	トースイケンノ スイ
推	スイリショーセツノ スイ
水	ミズノ スイ
炊	スイハンキノ スイ
睡	スイミンノ スイ
粋	ジュンスイノ スイ
翠	ホーセキ ヒスイノ スイ
衰	オトロエルノ スイ
遂	スイコースルノ スイ
酔	ヨー スイガンノ スイ
錐	サンカクスイノ スイ
錘	オモリノ スイ
随	シタガウ ズイイノ ズイ
瑞	ズイウンノ ズイ
髄	コツズイノ ズイ
崇	スーハイスルノ スー
嵩	ヤマノシタニタカイノ スー
数	カゾエル スーガクノ スー
枢	チュースーノ スー
趨	ハンスースルノ スー
雛	ヒナニンギョーノヒナノ スー
据	スエオキガタノ スエ
杉	ショクブツノ スギ
椙	キヘンノ スギ
菅	スゲガサノ スゲ
頗	カワヘンノ スコブル
雀	ヤチョーノ スズメ
裾	キモノノスソサバキノ スソ
澄	サンズイニノボルノ スム
摺	テヘンニ ナラウノ スリ
寸	スンポーノ スン
世	セカイノ セ
瀬	アサセノ セ
畝	メンセキノタンイノ セ
是	ゼヒノ ゼ
凄	スゴイ セイサンノ セイ
制	シャカイセイドノ セイ
勢	イキオイノ セイ
姓	ミョージ セイメイノ セイ
征	セイフクスルノ セイ
性	セイカクノ セイ
成	セイチョースルノ セイ
政	セイジノ セイ
整	セイリスルノ セイ
星	ホシノ セイ
晴	ハレルノ セイ
棲	スム ドーセイノ セイ
栖	キヘンニ ニシノ セイ
正	タダシイノ セイ
清	キヨイ セイケツノ セイ
牲	ギセイニナルノ セイ
生	イキル セイカツノ セイ
盛	セイダイナハクシュノ セイ
精	セイシンテキノ セイ
聖	ヒジリノ セイ
声	コエノ セイ
製	セイサクスルノ セイ
西	ホーガクノ ニシ
誠	マコトノ セイ
誓	チカウ セイガンショノ セイ
請	ヨーセイスルノ セイ
逝	ユク セイキョノ セイ
醒	サメルノ セイ
青	アオイロノ セイ
静	シズカ セイジャクノ セイ
斉	イッセイノ セイ
税	ゼイキンノ ゼイ
脆	モロイノ ゼイ
隻	フネヲ カゾエルトキノ セキ
席	シュッセキノ セキ
惜	オシイ セキベツノ セキ
戚	シンセキノ セキ
斥	ハイセキノ セキ
昔	セキ ムカシバナシノ ムカシ
析	ブンセキノ セキ
石	イシカワノ イシ
積	ツム セキサイスルノ セキ
籍	ショセキノ セキ
績	ボーセキノ セキ
脊	セキズイノ セキ
責	セメル セキニンノ セキ
赤	アカイノ セキ
跡	アト メイセキノ セキ
蹟	メイセキノ セキ
碩	オオキイ セキガクノ セキ
切	キル シンセツノ セツ
拙	マズイ チセツノ セツ
接	オーセツマノ セツ
摂	セッショースルノ セツ
折	オル ザセツスルノ セツ
設	モーケル セツビスルノ セツ
窃	ヌスム セットーノ セツ
節	フシ キセツノ セツ
説	トク ショーセツノ セツ
雪	ユキノ セツ
絶	カエル ゼッタイノ ゼツ
舌	シタ ベンゼツノ ゼツ
蝉	コンチューノ セミ
仙	センニンノ セン
先	セン:アトサキノ サキ
千	カンスージノ セン
占	ウラナウ センリョーチノ セン
宣	センゲンノ セン
専	モッパラ センモンノ セン
尖	トガル センエイノ セン
川	サンボンガワノ カワ
戦	タタカウノ セン
扇	オーギ センスノ セン
撰	エラブ テヘンノ セン
栓	センヲ スルノ セン
栴	センダンノ セン
泉	イズミ センスイノ セン
浅	アサイノ セン
洗	アラウ センタクノ セン
染	ソメル センショクノ セン
潜	モグル センスイノ セン
煎	センチャノ セン
煽	アオルノ セン
旋	センカイスルノ セン
穿	センサクスルノ セン
箭	タケカンムリニ マエノ セン
線	センヲ ヒクノ セン
繊	センイノ セン
羨	ウラヤムノ セン
腺	リンパセンノ セン
舛	ソムクノ セン
船	フネノ セン
薦	スイセンスルノ セン
詮	センギノ セン
賎	イヤシイノ セン
践	フムノ セン
選	エラブノ セン
遷	サセンノ セン
銭	キンセンノ セン
銑	センテツノ セン
閃	ヒラメクノ セン
鮮	アザヤカノ セン
前	マエ ゼンゴノ ゼン
善	ヨイノ ゼン
漸	ヨーヤク ゼンジノ ゼン
然	シゼンノ ゼン
全	マッタクノ ゼン
禅	ゼンドーノ ゼン
繕	ツクロウノ ゼン
膳	ショクゼンノ ゼン
糎	ナガサノノ センチ
噌	ミソノ ソ
塑	ソゾーノ ソ
岨	ソゴノ ソ
措	オクノ ソ
曾	カツテノ ソ
曽	カツテノ ソ
楚	シメンソカノ ソ
狙	ネラウノ ソ
疏	ウトンズルノ ソ
疎	ウトンズルノ ソ
礎	イシヅエノ ソ
祖	ソフボノ ソ
租	ソゼイノ ソ
粗	アライノ ソ
素	モトノ ソ
組	ソシキノ ソ
蘇	アソノ ソ
訴	ウッタエルノ ソ
阻	ハバムノ ソ
遡	サカノボルノ ソ
鼠	ネズミノ ソ
僧	ソーリョノ ソー
創	ツクルノ ソー
双	フタツノ ソー
叢	クサムラノ ソー
倉	クラノ ソー
喪	ソーシツスルノ ソー
壮	ソーネンノ ソー
奏	エンソーカイノ ソー
爽	サワヤカノ ソー
宋	ホクソーナンソーノ ソー
層	ソーヲ ナスノ ソー
匝	ハコガマエノ ソー
惣	スベテノ ソー
想	オモウノ ソー
捜	サガスノ ソー
掃	ソージスルノ ソー
挿	ソーニュースルノ ソー
掻	カクノ ソー
操	アヤツルノ ソー
早	ハヤイノ ソー
曹	ソートーシューノ ソー
巣	トリノ スバコノ ス
槍	ヤリノ ソー
槽	オケ ヨクソーノ ソー
漕	コグノ ソー
燥	カンソーノ ソー
争	アラソイノ ソー
痩	ヤセルノ ソー
相	ソーダンノ ソー
窓	マドガラスノ マド
糟	ソーコーノツマノ ソー
総	スベテノ ソー
綜	ソーゴーノ ソー
聡	ソーメイノ ソー
草	クサノ ソー
荘	ベッソーチノ ソー
葬	ホームルノ ソー
蒼	アオイノ ソー
藻	ウミクサノ ソー
装	ヨソオウノ ソー
走	ハシルノ ソー
送	オクルノ ソー
遭	アウノ ソー
鎗	ヤリノ ソー
霜	シモノ ソー
騒	サワグノ ソー
像	ブツゾーノ ゾー
増	フエルノ ゾー
憎	ニクムノ ゾー
臓	ゴゾーロップノ ゾー
蔵	クラ クサカンムリノ ゾー
贈	オクルノ ゾー
造	ツクルノ ゾー
促	ウナガスノ ソク
側	ハンタイガワノ ガワ
則	キソクノ ソク
即	スナワチノ ソク
息	イキ リソクノ ソク
捉	トラエルノ ソク
束	タバ ヤクソクノ ソク
測	ハカルノ ソク
足	アシ エンソクノ ソク
速	ジンソクキビンノ ソク
俗	ゾクセケンノ ゾク
属	フゾクスルノ ゾク
賊	カイゾクノ ゾク
族	カゾクノ ゾク
続	ケイゾクスルノ ゾク
卒	ソツギョーシキノ ソツ
袖	フリソデノ ソデ
其	ソレノ ソ
揃	ソロエルノ ソロ
存	ソンザイスルノ ソン
孫	シソンハンエイノ ソン
尊	ソンケイスルノ ソン
損	ソンヲ スルノ ソン
村	マチ ムラノ ムラ
遜	ケンソンスルノ ソン
他	タニンノ タ
多	オオイノ タ
太	フトイノ タ
汰	サンズイニフトイノ タ
詑	アザムクノ タ
唾	ダエキノ ダ
堕	ダラクスルノ ダ
妥	ダキョースルノ ダ
惰	オコタルノ ダ
打	ウツノ ダ
柁	キヘンノカジノ ダ
舵	カジ ホーコーダノ ダ
楕	ダエンケイノ ダ
陀	アミダブツノ ダ
駄	ムダノ ダ
騨	ヒダサンミャクノ ダ
体	カラダノ タイ
堆	タイセキブツノ タイ
対	ハンタイガワノ タイ
耐	ニンタイリョクノ タイ
岱	タイメイマチノ タイ
帯	オビノ タイ
待	セッタイスルノ タイ
怠	オコタルノ タイ
態	タイドノ タイ
戴	タイカンシキノ タイ
替	タイ キリカエノ カエ
泰	アンタイノ タイ
滞	トドコオルノ タイ
胎	ハラム ジュタイノ タイ
腿	ダイタイコツノ タイ
苔	コケノ タイ
袋	フクロノ タイ
貸	タイシャクスルノ タイ
退	シリゾクノ タイ
逮	タイホノ タイ
隊	グンタイノ タイ
黛	マユズミノ タイ
鯛	サカナノ タイ
代	ジダイノ ダイ
台	タイフーノ タイ
大	オオキイノ ダイ
第	ダイイチ インショーノ ダイ
醍	ダイゴミノ ダイ
題	ダイメイノ ダイ
鷹	トリノ タカ
滝	タキツボノ タキ
瀧	キュージノタキツボノ タキ
卓	タクエツスルノ タク
啄	ツイバムノ タク
宅	ジュータクノ タク
托	タクハツノ タク
択	センタクモンダイノ タク
拓	カイタクノ タク
沢	サワノ タク
濯	センタクキノ タク
琢	セッサ タクマノ タク
託	タクジショノ タク
鐸	ドータクノ タク
濁	ニゴルノ ダク
諾	ショーダクスルノ ダク
茸	クサカンムリニ ミミノ タケ
凧	ヤッコダコノ タコ
蛸	ウミニ イル タコノ タコ
只	タダミガワノ タダ
叩	タタクノ タタ
但	タダシガキノ タダ
達	トモダチノ タチ
辰	エトノ タツ
奪	リャクダツスルノ ダツ
脱	ダッピスルノ ダツ
巽	ホーガクノ タツミ
竪	タテアナノ タテ
辿	タドルノ タド
棚	タナアゲノ タナ
谷	タニガワノ タニ
狸	ドーブツノ タヌキ
鱈	サカナノ タラ
樽	サカダルノ タル
誰	ダレヒトリノ ダレ
丹	ボタンノ タン
単	タンイツノ タン
嘆	ナゲクノ タン
坦	ヘイタンチノ タン
担	ニナウ タントースルノ タン
探	サグルノ タン
旦	ガンタンノ タン
歎	ナゲクノ タン
淡	アワイノ タン
湛	ミズヲ タタエルノ タタエ
炭	セキタンノ タン
短	ミヂカイノ タン
端	センタンノ タン
箪	タンスノ タン
綻	ハタンスルノ タン
耽	フケルノ タン
胆	ダイタンノ タン
蛋	タンパクシツノ タン
誕	タンジョービノ タン
鍛	キタエルノ タン
団	ダンランノ ダン
壇	ブツダンノ ダン
弾	ダンヤクノ ダン
断	ハンダンスルノ ダン
暖	アタタカイノ ダン
檀	ダンカノ ダン
段	カイダンノ ダン
男	オトコノ オ
談	ダンワノ ダン
値	アタイノ チ
知	チシキノ チ
地	トチノ チ
弛	ユルムノ チ
恥	ハジノ チ
智	シルノシタニヒノ チ
池	タメイケノ イケ
痴	ハクチノ チ
稚	オサナイノ チ
置	ハイチスルノ チ
致	ガッチスルノ チ
蜘	ムシヘンニ シルノ チ
遅	オソイノ チ
馳	ゴチソーノ チ
築	ケンチクスルノ チク
畜	カチクノ チク
竹	タケヤブノ タケ
筑	チクゴノクニノ チク
蓄	タクワエルノ チク
逐	チクイチノ チク
秩	チツジョノ チツ
窒	チッソノ チツ
茶	オチャノ チャ
嫡	チャクナンノ チャク
着	トーチャクスルノ チャク
中	チューシンノ チュー
仲	ニンベンニ ナカノ チュー
宙	ウチュージダイノ チュー
忠	ナカニココロノ チュー
抽	チューセンノ チュー
昼	ヒルノ チュー
柱	ハシラノ チュー
注	ソソグノ チュー
虫	ムシノ チュー
衷	セッチューアンノ チュー
註	チューシャクノ チュー
酎	イモジョーチューノ チュー
鋳	チューゾーノ チュー
駐	チューシャキンシノ チュー
樗	キヘンニ シズクノ チョ
瀦	ミズタマリノ チョ
猪	ドーブツノ イノシシ
苧	タタズムノ チョ
著	アラワス チョシャノ チョ
貯	タクワエル チョキンノ チョ
丁	チョードノ チョー
兆	カンスージノ チョー
凋	チョーラクノ チョー
喋	シャベルノ チョー
寵	チョーアイスルノ チョー
帖	ガチョーノ チョー
帳	チョーメンノ チョー
庁	カンチョーノ チョー
弔	トムラウ ケイチョーノ チョー
張	キンチョースルノ チョー
彫	チョーコクカノ チョー
徴	シルシ チョーコーノ チョー
懲	コラス チョーアクノ チョー
挑	イドム チョーセンノ チョー
暢	リューチョーノ チョー
朝	アサ チョーショクノ チョー
潮	シオ チョーリューノ チョー
牒	フダノ チョー
町	ナニナニマチノ マチ
眺	ナガメルノ チョー
聴	キク チョーカクノ チョー
脹	フクレルノ チョー
腸	ジューニシチョーノ チョー
蝶	コンチューノ チョー
調	シラベル チョーサノ チョー
諜	チョーホーカツドーノ チョー
超	チョーエツスルノ チョー
跳	チョーヤクスルノ チョー
銚	チョーシシノ チョー
長	ナガイノ チョー
頂	イタダキノ チョー
鳥	トリ ヤチョーノ チョー
勅	チョクシヲ ツカワスノ チョク
捗	ハカドルノ チョク
直	ナオス チョクセンノ チョク
朕	コーテイノ ジショーノ チン
沈	チンボツスルノ チン
珍	メズラシイノ チン
賃	ヤチンノ チン
鎮	シズマルノ チン
陳	チンジョースルノ チン
津	オオツシノ ツ
墜	オチル ツイラクノ ツイ
椎	ツイ シイノキノ シイ
槌	テッツイヲ クダスノ ツイ
追	オウ ツイカスルノ ツイ
鎚	ツチウツヒビキノ ツチ
痛	イタイ ツーカクノ ツー
通	トオル ツーコースルノ ツー
塚	カイヅカノ ツカ
栂	キヘンニ ハハノ ツガ
掴	ツカムノ ツカ
槻	キヘンニ キソクノキノ ツキ
佃	ツクダニノ ツクダ
漬	ツケモノノ ツケ
柘	ニワキノ ツゲ
辻	ツジウラノ ツジ
蔦	ショクブツノ ツタ
綴	ツヅルノ ツヅ
鍔	カタナノ ツバ
椿	キヘンニ ハルノ ツバキ
潰	イカイヨーノ カイ
坪	トチノツボスーノ ツボ
壷	タキツボノ ツボ
嬬	オンナヘンニ ジュノ ツマ
紬	オリモノノ ツムギ
爪	ユビノツメノ ツメ
吊	ツリバシノ ツリ
釣	サカナツリノ ツリ
鶴	トリノ ツル
亭	テイシュノ テイ
低	ヒクイノ テイ
停	トドマル テイシノ テイ
偵	ウカガウ テイサツノ テイ
剃	ソル テイハツノ テイ
貞	テイシュクノ テイ
呈	ゾーテイスルノ テイ
堤	ツツミ テイボーノ テイ
定	サダメルノ テイ
帝	テイコクシュギノ テイ
底	ソコ カイテイノ テイ
庭	テイ ニワイシノ ニワ
廷	ホーテイニタツノ テイ
弟	オトートノ テイ
悌	リッシンヘンニ オトートノ テイ
抵	テイコースルノ テイ
挺	テイシンタイノ テイ
提	テイシュツノ テイ
梯	ダンバシゴノ ハシゴ
汀	ミギワノ テイ
碇	イカリ テイハクノ テイ
禎	シメスヘンニ テイノ テイ
程	ホドヨイノ ホド
締	テイケツスルノ テイ
艇	フネ ヒコーテイノ テイ
訂	テイセイスルノ テイ
諦	アキラメルノ テイ
蹄	ヒヅメノ テイ
逓	テイシンショーノ テイ
邸	ヤシキノ テイ
鄭	テイチョーニモテナスノ テイ
釘	カネヘンニ チョーノ クギ
鼎	カナエノ テイ
泥	ドロ デイスイノ デイ
摘	テキハツスルノ テキ
擢	バッテキスルノ テキ
敵	テキミカタノ テキ
滴	スイテキノ テキ
的	モクテキノ テキ
笛	フエ コテキタイノ テキ
適	テキセツノ テキ
鏑	ヤジリ メイテキノ テキ
溺	オボレルノ デキ
哲	テツガクノ テツ
徹	テッテイノ テツ
撤	テッパイノ テツ
轍	イッテツノ テツ
迭	コーテツノ テツ
鉄	テッコーセキノ テツ
典	ジテンノ テン
填	ウメル ジューテンノ テン
天	テンゴクノ テン
展	テンジカイノ テン
店	ミセノ テン
添	ソエルノ テン
纏	マトーノ テン
甜	アマイノ テン
貼	ハル テンプスルノ テン
転	コロブ カイテンノ テン
顛	テンマツノ テン
点	テンスーノ テン
伝	ツタエル デンセツノ デン
殿	トノ キューデンノ デン
澱	ヨドム チンデンノ デン
田	タンボノ タ
電	デンワノ デン
兎	ドーブツノ ウサギ
吐	ハク オートノ ト
堵	アンドスルノ ド
塗	ヌル トフスルノ ト
妬	シットスルノ ト
屠	トサツノ ト
徒	イタズラニノ ト
斗	ホクトシチセイノ ト
杜	キヘンニ ツチノ ト
渡	ワタル トカイスルノ ト
登	ノボル トザンノ ト
菟	クサカンムリニ ウサギノ ト
賭	カケル トバクノ ト
途	トチューノ ト
都	ミヤコノ ト
鍍	メッキ トキンノ ト
砥	トイシノ ト
砺	トイシノ ト
努	ドリョクスルノ ド
度	オンドノ ド
土	ツチノ ド
奴	ドレイノ ド
怒	イカル ゲキドノ ド
倒	ダトースルノ トー
党	セイジ セイトーノ トー
冬	キセツノフユノ トー
凍	コオル レイトーノ トー
刀	カタナノ トー
唐	トーガラシノ トー
塔	タテモノノ トー
塘	ツツミノ トー
套	ジョートーシュダンノ トー
宕	ウカンムリニ イシノ トー
島	トー シマグニノ シマ
嶋	ヤマニトリノ トー
悼	ツイトーノ トー
投	ナゲル トーシュノ トー
搭	トーサイノ トー
東	ホーガクノ ヒガシ
桃	モモノ トー
梼	キリカブノ トー
棟	ムネ イチゴートーノ トー
盗	ヌスム トーゾクノ トー
淘	シゼントータノ トー
湯	オユ ネットーノ トー
涛	ドトーノ トー
灯	トモシビ トーダイノ トー
燈	キュージ ウミノトーダイノ トー
当	アタル トーバンノ トー
痘	テンネントーノ トー
祷	キトーシノ トー
等	ヒトシイ ナドノ トー
答	トーアンヨーシノ トー
筒	エントーケイノ トー
糖	サトーノ トー
統	トーイツスルノ トー
到	トーチャクスルノ トー
董	コットーヒンノ トー
蕩	ホートームスコノ トー
藤	フジノハナノ フジ
討	トーバツスルノ トー
謄	コセキトーホンノ トー
豆	トーフノ トー
踏	ザットーノ トー
逃	トーボーシャノ トー
透	ムショクトーメイノ トー
鐙	アブミノ トー
陶	トージキノ トー
頭	アタマノ トー
騰	フットースルノ トー
闘	タタカウ トーギューノ トー
働	ロードーシャノ ドー
動	ドーブツノ ドー
同	オナジノ ドー
堂	ショクドーノ ドー
導	ミチビク シドーシャノ ドー
憧	リッシンベン アコガレノ ドー
撞	テヘンニ ワラベノ ドー
洞	ドークツノ ドー
瞳	ヒトミ ドーコーノ ドー
童	ワラベノ ドー
胴	ドーアゲノ ドー
萄	ブドーシュノ ドー
道	ミチノ ドー
銅	キンゾクノ ドー
峠	ヤマサカノ トーゲ
鴇	トリノ トキ
匿	トクメイノ トク
得	トクイニナルノ トク
徳	ジントクノ トク
涜	ボートクノ トク
特	トクチョーノ トク
督	カントクノ トク
禿	ハゲノ トク
篤	トクシカノ トク
毒	ドクブツノ ドク
独	コドクノ ドク
読	ドクショノ ドク
栃	トチギケンノ トチ
橡	キヘンニ ゾーノ トチ
凸	オートツノ トツ
突	ショートツスルノ トツ
椴	トドマツノ トド
届	トドケルノ トドケ
鳶	トビショクノ トビ
苫	トマコマイシノ トマ
寅	エトノ トラ
酉	エトノ トリ
瀞	サンズイニシズカノ トロ
噸	オモサノタンイノ トン
屯	チュートンスルノ トン
惇	トン マコトノ ジュン
敦	チューゴクノトンコーノ トン
沌	コントンノ トン
豚	ブタノ トン
遁	トンソーノ トン
頓	トンキョーノ トン
呑	ノミコミガハヤイノ ノ
曇	クモリ ドンテンノ ドン
鈍	ニブイ ドンカンノ ドン
奈	ナラケンノ ナ
那	オキナワノナハシノ ナ
内	ナイガイノ ナイ ウチ
乍	ムカシナガラノ ナガラ
凪	ユーナギノ ナギ
薙	クサナギノツルギノ ナギ
謎	ナゾナゾノ ナゾ
灘	エンシューナダノ ナダ
捺	ナツインスルノ ナツ
鍋	ナベカマノ ナベ
楢	ナラノキノ ナラ
馴	ウマヘンニ カワノ ナレ
縄	ナワバリノ ナワ
畷	シジョーナワテノ ナワテ
南	ホーガクノ ミナミ
楠	クスノキノ ナン
軟	ヤワラカイノ ナン
難	ムズカシイノ ナン
汝	ナンジラワノ ジョ
二	カンスージノ ニ
尼	アマノ ニ
弐	カンスージノ ニ
迩	シンニューニノ ニ
匂	ニオイガスルノ ニオ
賑	ニギヤカノ ニギ
肉	キンニクノ ニク
虹	ニジイロノ ニジ
廿	スージノ ニジュー
日	ニチヨービノ ニチ
乳	ギューニューノ ニュー
入	ハイルノ ニュー
如	アミダニョライノ ニョ
尿	フンニョーノ ニョー
韮	ニラサキシノ ニラ
任	ニンムニツクノ ニン
妊	ニンシンスルノ ニン
忍	シノブ ニンタイノ ニン
認	ミトメルノ ニン
濡	ヌレルノ ヌレ
禰	ネギ カンヌシ ノ ネ
祢	シメスヘンノ ネ
寧	テイネイノ ネイ
葱	ヤサイノ ネギ
猫	ミケネコノ ネコ
熱	ネツジョーノ ネツ
年	ネンゲツノ ネン
念	ネンブツノ ネン
捻	ネンザノ ネン
撚	ネンシコーバノ ネン
燃	ネンリョーノ ネン
粘	ネンチャクテープノ ネン
乃	ナイシノ ナイ
廼	エンニョーノ ノ
之	コレ ナニナニノスケノ ノ
埜	ノハラノ ノノ カエジノ ノ
嚢	フクロノ ノー
悩	クノースルノ ノー
濃	ノーシュクスルノ ノー
納	オサメルノ ノー
能	ノーリョクノ ノー
脳	ダイノーノ ノー
膿	カノースルノ ノー
農	ノーギョーノ ノー
覗	ノゾキミルノ ノゾ
蚤	ムシノ ノミ
巴	ミツドモエノ トモエ
把	ハアクスルノ ハ
播	タネヲ マクイミノ ハ
覇	セイハスルノ ハ
杷	ビワノキノ ハ
波	ナミ ハチョーノ ハ
派	ハバツノ ハ
琶	ビワコノ ハ
破	ハカイスルノ ハ
婆	ローバシンノ バ
罵	ノノシル バトースルノ バ
芭	ミズバショーノ バ
馬	ウマノ バ
俳	ハイクノ ハイ
廃	ハイシスルノ ハイ
拝	オガムノ ハイ
排	ハイキガスノ ハイ
敗	ハイボクノ ハイ
杯	シュクハイヲ アゲルノ ハイ
盃	サカズキノ ゾクジノ ハイ
牌	イハイノ ハイ
背	ハイゴカンケイノ ハイ
肺	ハイゾーノ ハイ
輩	ヤカラ センパイノ ハイ
配	ハイタツスルノ ハイ
倍	バイリツノ バイ
培	バイヨースルノ バイ
媒	バイカイスルノ バイ
梅	ウメ ニューバイノ バイ
楳	ウメノフルイジノ バイ
煤	スス バイエンノ バイ
狽	ローバイスルノ バイ
買	カウノ バイ
売	ウル ショーバイノ バイ
賠	バイショーキンノ バイ
陪	シタガウノ バイ
這	アカチャンガハウノ ハウ
蝿	ムシノ ハエ
秤	ハカリ テンビンノ ビン
矧	ユミヤヲ ツクル イミノ ハギ
萩	ショクブツノ ハギ
伯	ハクシャクノ ハク
剥	ハクダツスルノ ハク
博	ハクランカイノ ハク
拍	ハクシュスルノ ハク
柏	ショクブツノカシワノ ハク
泊	シュクハクスルノ ハク
白	シロイロノ ハク
箔	キンパクノ ハク
粕	サケカスノ カス
舶	ハクライヒンノ ハク
薄	ウスイ ケイハクノ ハク
迫	ハクリョクノ ハク
曝	バクロスルノ バク
漠	サバクノ バク
爆	バクハツスルノ バク
縛	シバル ソクバクノ バク
莫	バクダイノ バク
駁	ハンバクヲ クワエルノ バク
麦	ムギ バクガノ バク
函	ハコダテノ ハコ
箱	ハコニワノ ハコ
硲	イシヘンニ タニノ ハザマ
箸	ワリバシノ ハシ
肇	モノノ ハジメノ ハジメ
筈	テハズノ ハズ
櫨	ハゼノキノ ハゼ
幡	ヤハタノ ハタ
肌	ハダイロノ ハダ
畑	タハタノ ハタケ
畠	シロイノ シタニ タノ ハタケ
八	カンスージノ ハチ
鉢	ハチウエノ ハチ
溌	ハツラツノ ハツ
発	シュッパツノ ハツ
醗	サケガ ハッコースルノ ハツ
髪	モーハツノ ハツ
伐	バッサイスルノ バツ
罰	バッキンノ バツ
抜	ヌク バッスイスルノ バツ
筏	イカダノ バツ
閥	ザイバツノ バツ
鳩	トリノ ハト
噺	ムカシバナシノ ハナシ
塙	ツチヘンニ タカイノ ハナワ
蛤	ニマイガイノ ハマグリ
隼	トリノ ハヤブサ
伴	トモナウ ハンリョノ ハン
判	ハンダンスルノ ハン
半	ハンブンノ ハン
反	ハンタイスルノ ハン
叛	ソムク ハンランノ ハン
帆	ホバシラノ ホ
搬	ウンパンスルノ ハン
斑	マダラ ハンテンノ ハン
板	ハン イタジキノ イタ
氾	ヒロガルノ ハン
汎	ヒロシ ハンヨーノ ハン
版	シュッパンブツノ ハン
犯	ハンニンノ ハン
班	ハンチョーノ ハン
畔	ホトリ コハンノ ハン
繁	シゲル ハンエイスルノ ハン
般	イッパンテキノ ハン
藩	エドジダイノ ハンノ ハン
販	ハンバイスルノ ハン
範	ハンイノ ハン
釆	ノゴメヘン ワケルノ ハン
煩	ワズラワシイノ ハン
頒	ハンプスルノ ハン
飯	メシ ゴハンノ ハン
挽	ヒク バンカノ バン
晩	アサバンノ バン
番	ジュンバンノ バン
盤	ラシンバンノ バン
磐	イワ ハンノシタニイシノ バン
蕃	バンジンミトーノ バン
蛮	ナンバンワタリノ バン
匪	ヒゾクノ ヒ
卑	イヤシイノ ヒ
否	ヒテイスルノ ヒ
妃	キサキ オウヒノ ヒ
庇	ヒゴスルノ ヒ
彼	ヒガンノ ヒ
悲	カナシイノ ヒ
扉	トビラノ ヒ
批	ヒハンスルノ ヒ
披	ヒローエンノ ヒ
斐	ナマエノ アヤ
比	ヒカクスルノ ヒ
泌	ヒニョーキノ ヒ
疲	ヒロースルノ ヒ
皮	ヒフノ ヒ
碑	セキヒノ ヒ
秘	ヒミツノ ヒ
緋	ヒイロノ ヒ
罷	ヒメンスルノ ヒ
肥	ヒリョーノ ヒ
被	ヒガイノ ヒ
誹	ヒボーノ ヒ
費	ヒヨーノ ヒ
避	サケルノ ヒ
非	アラズノ ヒ
飛	トブ ヒコーキノ ヒ
樋	キヘンニ トオルノ ヒ
簸	アオル タケカンムリノ ハノ ヒ
備	ジュンビノ ビ
尾	ビテイコツノ ビ
微	ケンビキョーノ ビ
枇	クダモノノビワノ ビ
毘	ビシャモンテンノ ビ
琵	ビワコノ ビ
眉	マユノ ビ
美	ウツクシイノ ビ
鼻	ハナ ジビカノ ビ
柊	キヘンノ ヒイラギ
稗	ノギヘンニ イヤシイノ ヒエ
匹	ドウブツノカズノ ヒキ
疋	タンモノノカズノ ヒキ
髭	アゴヒゲノ ヒゲ
彦	ヒコボシノ ヒコ
膝	ヒザカンセツノ ヒザ
菱	ヒシガタノ ヒシ
肘	ニクヅキニスンノ ヒジ
弼	スケノ ヒツ
必	カナラズノ ヒツ
畢	コトゴトクノ ヒツ
筆	フデノ ヒツ
逼	セマルノ ヒツ
桧	ヒノキヅクリノ ヒノキ
姫	オヒメサマノ ヒメ
媛	エヒメケンノ ヒメ
紐	ヒモトクノ ヒモ
百	カンスージノ ヒャク
謬	ゴビューノ ビュー
俵	タワラノ ヒョー
彪	トラニノ ヒョー
標	モクヒョーノ ヒョー
氷	コオリノ ヒョー
漂	タダヨーノ ヒョー
瓢	ヒョータンノ ヒョー
票	トーヒョースルノ ヒョー
表	オモテノ ヒョー
評	ヒョーバンノ ヒョー
豹	ヒョーヘンスルノ ヒョー
廟	マダレニアサノ ビョー
描	エガクノ ビョー
病	ヤマイ ビョーキノ ビョー
秒	ビョーキザミノ ビョー
苗	ナエノ ビョー
錨	カネヘンニ ナエノ ビョー
鋲	ガビョーノ ビョー
蒜	ヒルゼンノ ヒル
蛭	ムシヘンニ イタルノ ヒル
鰭	サカナノ セビレノ ヒレ
品	シナ ヒンモクノ ヒン
彬	ハヤシニサンヅクリノ ヒン
斌	ウルワシイノ ヒン
浜	ヒン スナハマノ ハマ
瀕	ヒンシノジューショーノ ヒン
貧	ヒンコンノ ヒン
賓	ライヒンノ ヒン
頻	ヒンパンノ ヒン
敏	ビンカンノ ビン
瓶	ビンヅメノ ビン
不	フカノーノ フ
付	ツク フチャクノ フ
埠	フネノ フトーノ フ
夫	オット フーフノ オ
婦	フジンノ フ
富	トミ ヒンプノ フ
冨	フジサンノ フ
布	ヌノ モーフノ フ
府	オオサカフノ フ
怖	コワイ キョーフノ フ
扶	フヨーカゾクノ フ
敷	シク フセツスルノ フ
斧	オノ ツチノシタニキンノ フ
普	フキュースルノ フ
浮	ウク フチンノ フ
父	チチ フボノ フ
符	フゴーノ フ
腐	クサル フハイノ フ
膚	ヒフノ フ
芙	フヨーノハナノ フ
譜	ガクフノ フ
負	マケルノ フ
賦	フエキノ フ
赴	オモムク フニンスルノ フ
阜	ギフケンノ フ
附	コザトヘンノフゾクノ フ
侮	ブジョクスルノ ブ
撫	ナデル アイブスルノ ブ
武	ブシノ ブ
舞	マウ ブトーカイノ ブ
葡	クダモノノブドーノ ブ
蕪	ヤサイノカブノ ブ
部	ブブンノ ブ
封	フートーノ フー
楓	カエデノ フー
風	カゼノ フー
葺	カヤブキヤネノ フキ
蕗	フキノトーノ フキ
伏	キフクニトムノ フク
副	ソエル フクサヨーノ フク
復	オーフクノ フク
幅	ハバトビノ ハバ
服	ヨーフクノ フク
福	コーフクノ フク
腹	ハラ クーフクノ フク
複	フクザツノ フク
覆	フクメンノ フク
淵	ミズノ フカイ フチ
弗	フッソ カゴーブツノ フツ
払	ハラウノ フツ
沸	フットースルノ フツ
仏	ホトケ ブツゾーノ ブツ
物	モノ ブッシツノ ブツ
鮒	サカナノ フナ
分	ワケルノ ブン
吻	セッブンノ フン
噴	カザンフンカノ フン
墳	コフンノ フン
憤	フンガイスルノ フン
扮	フンソースルノ フン
焚	タキビノ タキ
奮	フンパツスルノ フン
粉	コナノ フン
糞	フンニョーノ フン
紛	フンシツスルノ フン
雰	フンイキノ フン
文	サクブンノ ブン
聞	キク シンブンノ ブン
丙	コーオツヘイノ ヘイ
併	ヘイゴーノ ヘイ
兵	ヘイタイノ ヘイ
塀	ヘイガキノ ヘイ
幣	カヘイノ ヘイ
平	タイラ ヘイメンノ ヘイ
弊	ヘイガイノ ヘイ
柄	メイガラノ ガラ
並	ナラブ ヘイコーノ ヘイ
蔽	オオウ シャヘイノ ヘイ
閉	トジルノ ヘイ
陛	テンノーヘイカノ ヘイ
米	コメノ ベイ
頁	オーガイノ ページ
僻	ヘキチノ ヘキ
壁	カベノ ヘキ
癖	クセノ ヘキ
碧	コンペキノ ペキ
別	ワカレルノ ベツ
瞥	イチベツノ ベツ
蔑	ケイベツスルノ ベツ
箆	タケベラノ ヘラ
偏	カタヨルノ ヘン
変	カワルノ ヘン
片	カタホーノ ヘン
篇	チョーヘンショーセツノ ヘン
編	ヘンシュースルノ ヘン
辺	ニトーヘンサンカクケイノ ヘン
返	カエス ヘンカンノ ヘン
遍	オヘンロサンノ ヘン
便	ユービンノ ビン
勉	ベンキョーノ ベン
娩	ブンベンノ ベン
弁	ベンゴシノ ベン
鞭	ベンタツノ ベン
保	タモツ ホケンノ ホ
舗	ホソードーロノ ホ
鋪	カネヘンニ トホノノ ホ
圃	タンボノ ホ
捕	トラエルノ ホ
歩	アユム ホコーノ ホ
甫	ジンメイノハジメノ ホ
補	オギナウノ ホ
輔	ジンメイ クルマヘンノ スケ
穂	イナホノ ホ
募	ツノル ボシューノ ボ
墓	ハカ ボチノ ボ
慕	シタウ ボジョーノ ボ
戊	ジュッカンノツチノエノ ボ
暮	ユーグレノ クレ
母	ハハノ ボ
簿	シュッセキボノ ボ
菩	ボサツノ ボ
倣	モホースルノ ホー
俸	ホーキューノ ホー
包	ツツムノ ホー
呆	アホーノ ホー
報	ホーコクスルノ ホー
奉	タテマツル ホーシスルノ ホー
宝	タカラ ホーモツノ ホー
峰	ヤマヘンノミネノ ホー
峯	ヤマカンムリノミネノ ホー
崩	クズレル ホーカイノ ホー
庖	ホーチョーノ ホー
抱	イダク ホーフノ ホー
捧	ササゲルノ ホー
放	ハナツ ホーソーキョクノ ホー
方	ホーガクノ ホー
朋	トモ ホーユーノ ホー
法	ホーリツノ ホー
泡	アワ キホーノ ホー
烹	カッポーノ ホー
砲	タイホーノ ホー
縫	ヌウ ホーゴースルノ ホー
胞	ソシキサイボーノ ホー
芳	カンバシイノ ホー
萌	モエデルノ ホー
蓬	ヨモギノ ホー
蜂	ハチ ヨーホーノ ホー
褒	ゴホービノ ホー
訪	オトズレル ホーモンノ ホー
豊	ユタカ ホーサクノ ホー
邦	クニ レンポーノ ホー
鋒	キューセンポーノ ホー
飽	ホーワジョータイノ ホー
鳳	トリノ ホーオーノ ホー
鵬	オオトリノ ホー
乏	ビンボーノ ボー
亡	ナクナル シボーノ ボー
傍	カタワラ ロボーノ ボー
剖	カイボーガクノ ボー
坊	ボーズノ ボー
妨	サマタゲルノ ボー
帽	カブルボーシノ ボー
忘	ワスレルノ ボー
忙	イソガシイノ ボー
房	ニョーボーノ ボー
暴	アバレルノ ボー
望	ノゾム キボーノ ボー
某	ナニナニガシカノ ボー
棒	ボーキレノ ボー
冒	ボーケンノ ボー
紡	ツムグ ボーセキノ ボー
肪	ヒカシボーノ ボー
膨	フクラムノ ボー
謀	ハカリゴトノ ボー
貌	カオ ビボーノ ボー
貿	ボーエキノ ボー
鉾	カネヘンノ ホコ
防	フセグ ボーエイノ ボー
吠	イヌガホエルノ ホエ
頬	ホオカブリノ ホオ
北	ホーガクノ キタ
僕	シモベノ ボク
卜	ウラナウノ ボク
墨	スミ スイボクガノ ボク
撲	ウツ ダボクノ ボク
朴	ソボクノ ボク
牧	ボクジョーノ ボク
睦	シンボクダンタイノ ボク
穆	ヤワラグノ ボク
釦	キンボタンノ ボタン
勃	オコル ボッコーノ ボツ
没	チンボツノ ボツ
殆	フクシノ ホトンド
堀	ホリバタノ ホリ
幌	サッポロシノ ホロ
奔	ホンソースルノ ホン
本	ホンバコノ ホン
翻	ホンヤクノ ホン
凡	ヘイボンノ ボン
盆	ボンチノ ボン
摩	マサツスルノ マ
磨	ミガク ケンマノ マ
魔	マホーツカイノ マ
麻	マヤクノ マ
埋	ウメル マイソーノ マイ
妹	イモートノ マイ
昧	ゼイタクザンマイノ マイ
枚	マイスーノ マイ
毎	マイニチノ マイ
哩	キョリノタンイノ マイル
槙	ショクブツノ マキ
幕	マクギレノ マク
膜	フクマクエンノ マク
枕	シングノ マクラ
鮪	サカナノ マグロ
柾	ザイモクノマサメノ マサ
鱒	サカナノ マス
桝	イッショーマスノ マス
亦	セツゾクシノ マタ
俣	ミナマタシノ マタ
又	マタコンドノ マタ
抹	マッチャノ マツ
末	スエ ゲツマツノ マツ
沫	サンズイニスエノ マツ
迄	コレマデノ マデ
侭	ソノママニシテノ ママ
繭	カイコノ マユ
麿	アサノシタニロノ マロ
万	カンスージノ マン
慢	ジマンノ マン
満	ミタス ジューマンノ マン
漫	マンガノ マン
蔓	カゼノマンエンノ マン
味	ミ アジツケノ アジ
未	ミライノ ミ
魅	ミリョクノ ミ
巳	エトノ ミ
箕	タケカンムリニ ソノノ ミ
岬	ムロトミサキノ ミサキ
密	ヒミツノ ミツ
蜜	ハチミツノ ミツ
湊	ミナトガワノ ミナト
蓑	ミノムシノ ミノ
稔	ノギヘンジンメイノ ミノル
脈	ミャクハクノ ミャク
妙	ビミョーナチガイノ ミョー
粍	ナガサノタンイノ ミリ
民	ミンシュシュギノ ミン
眠	ネムル スイミンノ ミン
務	ツトメル ジムノ ム
夢	ユメ ムソーノ ム
無	ナシ ムゴンノ ム
牟	シャカムニノ ム
矛	ホコ ムジュンノ ム
霧	キリ ノームノ ム
鵡	ムカワチョーノ ム
椋	ムクドリノ ムク
婿	ハナムコノ ムコ
娘	オンナヘンニ ヨイノ ムスメ
冥	メイフクヲ イノルノ メイ
名	ジューショシメイノ メイ
命	イノチ ウンメイノ メイ
明	アカルイノ メイ
盟	メイユーノ メイ
迷	マヨー メイロノ メイ
銘	メイガラノ メイ
鳴	ナル ライメイノ メイ
姪	オジサントメイノ メイ
牝	ケモノノメスノ イミノ メス
滅	ゼンメツスルノ メツ
免	メンキョノ メン
棉	ワタ メンカノ メン
綿	ワタ モメンノ メン
緬	チリメンノ メン
面	オモテ メンセツノ メン
麺	メンルイノ メン
摸	アンチューモサクノ モ
模	モハンノ モ
茂	シゲル ハンモノ モ
妄	ヒガイモーソーノ モー
孟	モーシノ モー
毛	モーハツノ モー
猛	モーレツノ モー
盲	モーモクノ モー
網	アミ ツーシンモーノ モー
耗	ショーモーヒンノ モー
蒙	ケイモーノ モー
儲	カネモーケノ モー
木	ジュモクノ モク
黙	ダマル チンモクノ モク
目	モク メジルシノ メ
杢	キノ シタニツチノ モク
勿	オゴルナカレノ ナカレ
餅	モチゴメノ モチ
尤	セツゾクシノ モットモ
戻	モドルノ モド
籾	モミガラノ モミ
貰	モラウノ モラ
問	モンダイノ モン
悶	ハンモンノ モン
紋	モンツキノ モン
門	モンガマエノ モン
匁	シャッカンホーノ モンメ
也	ナリノ ヤ
冶	ヤキンガクノ ヤ
夜	ヨル シンヤノ ヤ
爺	コーコーヤノ ヤ
耶	ヤマタイコクノ ヤ
野	ノハラノ ノ
弥	ヤヨイサンガツノ ヤ
矢	ユミヤノ ヤ
厄	ヤクバライノ ヤク
役	ヤクニンノ ヤク
約	ヤクソクノ ヤク
薬	クスリノ ヤク
訳	ホンヤクノ ヤク
躍	カツヤクノ ヤク
靖	ヤスクニジンジャノ ヤス
柳	ショクブツノ ヤナギ
薮	タケヤブノ ヤブ
鑓	カネヘンノ ヤリ
愉	タノシイ ユカイノ ユ
愈	フクシノ イヨイヨ
油	アブラ セキユノ ユ
癒	ナオル チユスルノ ユ
諭	サトス セツユノ ユ
輸	ユシュツニューノ ユ
唯	ユイイツノ ユイ
佑	ニンベンニ ミギノ ユー
優	ヤサシイ ユービノ ユー
勇	イサマシイ ユーキノ ユー
友	トモ ユージンノ ユー
宥	ユルス ユーワノ ユー
幽	ユーレイノ ユー
悠	ユーゼントシテノ ユー
憂	ウレイ ユーウツノ ユー
揖	リョーテヲ クムエシャクノ ユー
有	アル コユーノ ユー
柚	ショクブツノ ユ
湧	ワキミズノ ワク
涌	リュー ワクノ カエジノ ワク
猶	ユーヨノ ユー
猷	ハカリゴトノ ユー
由	ジユーノ ユー
祐	シメスヘンノ ユー
裕	ユーフクノ ユー
誘	サソウ ユーワクノ ユー
遊	アソブ ユーエンチノ ユー
邑	ムラザトノ ユー
郵	ユービンノ ユー
雄	エイユーノ ユー
融	キンユーノ ユー
夕	ユーガタノ ユー
予	ヨテイノ ヨ
余	アマリ ヨジョーノ ヨ
与	アタエル カンヨノ ヨ
誉	メイヨノ ヨ
輿	コシ ヨロンノ ヨ
預	アズケルノ ヨ
傭	ヤトウ コヨーノ ヨー
幼	オサナイ ヨーチエンノ ヨー
妖	ヨーカイ ヘンゲノ ヨー
容	イレル ヨーボーノ ヨー
庸	ボンヨーノ ヨー
揚	アゲル ヨクヨーノ ヨー
揺	ユスル ドーヨースルノ ヨー
擁	イダクノ ヨー
曜	ニチヨービノ ヨー
楊	ヤナギノ イミノ ヨー
様	ナニナニサマノ サマ
洋	セイヨーノ ヨー
溶	トカス ヨーエキノ ヨー
熔	トカス ヨーコーロノ ヨー
用	モチイル シヨースルノ ヨー
窯	ヨーギョーノ ヨー
羊	ヒツジノ ヨー
耀	カガヤクノ ヨー
葉	コノハノ ヨー
蓉	フヨーノ ハナノ ヨー
要	カナメノ ヨー
謡	ヨーキョクノ ヨー
踊	オドルノ ヨー
遥	ハルカノ ヨー
陽	タイヨーノ ヨー
養	ヤシナウノ ヨー
慾	ヨクボーノ ヨクノ キュージノ ヨク
抑	ヨクセイノ ヨク
欲	ヨクボーノ ヨク
沃	ヒヨクノ ヨク
浴	アビルノ ヨク
翌	ヨクジツノ ヨク
翼	ツバサノ ヨク
淀	ヨドガワノ ヨド
羅	モーラスルノ ラ
螺	ラセンカイダンノ ラ
裸	ハダカ ラタイノ ラ
来	ライネンノ ライ
莱	ホーライノ ライ
頼	シンライスルノ ライ
雷	カミナリノ ライ
洛	ラクチューノ ラク
絡	レンラクスルノ ラク
落	オチルノ ラク
酪	ラクノーノ ラク
乱	ミダレルノ ラン
卵	タマゴノ ラン
嵐	ヤマノシタニカゼノ ラン
欄	ランガイノ ラン
濫	ミズガ ハンランスルノ ラン
藍	ガランノ ラン
蘭	ランノハナノ ラン
覧	カンランノ ラン
利	リエキノ リ
吏	カンリノ リ
履	リレキショノ リ
李	クダモノノ スモモノ リ
梨	クダモノノ ナシ
理	リユーノ リ
璃	ルリノ リ
痢	ゲリノ リ
裏	ウラオモテノ ウラ
裡	コロモヘンニ サトノ リ
里	フルサトノ サト
離	ハナレルノ リ
陸	リクチノ リク
律	センリツノ リツ
率	ヒイル ヒリツノ リツ
立	ドクリツノ リツ
葎	ショクブツノ ムグラ
掠	リャクダツノ リャク
略	ショーリャクノ リャク
劉	ジンメイノ リュー
流	ヒョーリューノ リュー
溜	タメル リューインノ リュー
琉	リューキューノ リュー
留	トドマルノ リュー
硫	リューサンノ リュー
粒	コメツブノ ツブ
隆	リューキスルノ リュー
竜	タツ ゾクジノ リュー
龍	タツ ホンジノ リュー
侶	ハンリョノ リョ
慮	シリョブカイノ リョ
旅	リョコーノ タビ
虜	トリコ ホリョノ リョ
了	シューリョースルノ リョー
亮	ジンメイ スケノ リョー
僚	ドーリョーノ リョー
両	リョーリツスルノ リョー
凌	シノグノ リョー
寮	ドクシンリョーノ リョー
料	リョーリノ リョー
梁	トーリョーノ リョー
涼	スズシイノ リョー
猟	リョージューノ リョー
療	チリョースルノ リョー
瞭	メイリョーナノ リョー
稜	ヤマノ リョーセンノ リョー
糧	ショクリョーノ リョー
良	ヨイノ リョー
諒	リョーカイスルノ リョー
遼	ハルカノ リョー
量	ハカルノ リョー
陵	ミササギ ゴリョーノ リョー
領	リョーイキノ リョー
力	チカラノ リョク
緑	ミドリノ リョク
倫	リンリノ リン
厘	タンイ イチリンノ リン
林	シンリンノ ハヤシ
淋	サビシイノ リン
燐	オーリン セキリンノ リン
琳	オーヘンニ ハヤシノ リン
臨	ノゾムノ リン
輪	シャリンノ リン
隣	トナリアウノ トナリ
鱗	ウロコノ リン
麟	キリンノ リン
瑠	ルリノ ル
塁	イチルイノ ルイ
涙	ナミダノ ルイ
累	ルイセキノ ルイ
類	シンルイノ ルイ
令	メイレイノ レイ
伶	ニンベンノ レイ
例	タメシノ レイ
冷	ツメタイノ レイ
励	ハゲマスノ レイ
嶺	ミネ ブンスイレイノ レイ
怜	リッシンベンノ レイ
玲	オーヘンニ レイノ レイ
礼	レイセツノ レイ
苓	ショクブツノ ミミナグサノ レイ
鈴	スズノ レイ
隷	ドレイノ レイ
零	コボレルノ レイ
霊	レイコンノ レイ
麗	ウルワシイノ レイ
齢	ネンレイノ レイ
暦	コヨミノ レキ
歴	レキシノ レキ
列	タイレツノ レツ
劣	オトルノ レツ
烈	ハゲシイノ レツ
裂	ブンレツノ レツ
廉	レンカノ レン
恋	レンアイノ レン
憐	アワレムノ レン
漣	サザナミノ レン
煉	レンガノ レン
簾	スダレノ レン
練	レンシューノ レン
聯	ツラナルノ レン
蓮	ハス レンコンノ レン
連	カンレンノ レン
錬	タンレンノ レン
呂	フロノ ロ
魯	ロドンノ ロ
櫓	ヤグラノ ロ
炉	ロバタノ ロ
賂	ワイロノ ロ
路	ドーロノ ロ
露	ツユ ロシュツノ ロ
労	ローリョクノ ロー
婁	スソヲ ヒク イミノ ロー
廊	ローカノ ロー
弄	モテアソブノ ロー
朗	ロードクノ ロー
楼	ローカクノ ロー
榔	ビンローノ ロー
浪	ナミ ローニンノ ロー
漏	モレル ローデンノ ロー
牢	ローゴクノ ロー
狼	ローゼキノ ロー
篭	カコム トーローノ ロー
老	ロージンノ ロー
聾	ローガッコーノ ロー
蝋	ローソクノ ロー
郎	タローノ ロー
六	カンスージノ ロク
麓	フモト サンロクノ ロク
禄	ロクダカノ ロク
肋	アバラ ロッコツノ ロク
録	キロクノ ロク
論	ギロンノ ロン
倭	ワノクニノ ワ
和	オダヤカ ヘイワノ ワ
話	ハナシノ ワ
歪	ヒズミ ワイキョクノ ワイ
賄	マカナウ ワイロノ ワイ
脇	ワキバラノ ワキ
惑	マドウ メイワクノ ワク
枠	マドワクノ ワク
鷲	トリノ ワシ
亙	ジンメイノ ワタル
亘	カキネノ カキノ ツクリノ ワタル
鰐	ドーブツノ ワニ
詫	ワビルノ ワビ
藁	ムギワラノ ワラ
蕨	ショクブツノ ワラビ
椀	キヘンノ チャワンノ ワン
湾	イリエノ ワン
碗	イシヘンノ チャワンノ ワン
腕	ワンリョクノ ワン
弌	イチノ キュージタイノ イチ
丐	アタエルノ カイ
丕	オオキイノ ヒ
个	カイジョノノ カ
丱	オサナイノ カン
丶	ウガンムリノノ チュー
丼	ドンブリノ タン
丿	ジケイノノ ヘツ
乂	カシコイノ ガイ
乖	ソムクノ カイ
乘	キュージ ノルノ ジョー
亂	フルイノ ラン
亅	シタマガリノ ケツ
豫	フルイノ ヨ
亊	リャクジノノ コト
舒	ノビルノ ジョ
弍	コジ カンスージノ ニ
于	カンスージノ ニニ ハネボーノ アア
亞	キュージ アネッタイノ ア
亟	スミヤカノ キョク
亠	カンムリノ ナベブタ
亢	タカブルノ コー
亰	ミヤコノ ゾクジノ キョー
亳	インノノ ハク
亶	ホシイノ タン
从	ヒトナラビノ ショー
仍	チナミノ ジョー
仄	ホノカノ ソク
仆	タオレルノ フ
仂	アマリノ ロク
仗	マモル ニンベンニ ジョーブノ ジョー
仞	ニンベンニ ヤイバノ キュージノ ヒロ
仭	ニンベンノ モンメ
仟	フナオサノ オサ
价	オオキイノ ヨシ
伉	タグイナラブノ コー
佚	アソブノ イツ
估	コケンノ コ
佛	フルイノ ブツ
佝	クルビョーノ ク
佗	ワビズマイノ ワビシイ
佇	タタズムノ チョ
佶	ニンベンニ キチジツノ キチノ タダシイ
侈	オゴリタカブルノ シ
侏	コビトノ シュ
侘	ホコリノ タ
佻	アサハカノ チョー
佩	ココロニノ ハイ
佰	オサノ ハク
侑	タスケルノ ユー
佯	イツワルノ ヨー
來	フルイノ ライ
侖	マルイノ ロン
儘	ニンベンニ ツクスノ ジン
俔	ニンベンニ ミルノ ケン
俟	サカンノ シ
俎	マナイタノ ソ
俘	トリコニノ フ
俛	ツトメルノ ベン
俑	ヒトガタノ ヨー
俚	イヤシイノ リ
俐	レイリノ リ
俤	ニンベンノ オモカゲ
俥	ジンリキシャノ クルマ
倚	ヨリカカルノ イ
倨	オゴリタカブルノ キョ
倔	クッキョーナノ クツ
倪	オサナゴノ ゲイ
倥	イソガシイノ コー
倅	ムスコノ セガレ
伜	ゾクジノ セガレ
俶	ハジメノ シュク
倡	ゲイニンノ ショー
倩	ウツクシイノ セン
倬	アキラカノ タク
俾	ツカサドルノ ヒ
俯	フセルノ フ
們	トモガラノ モン
倆	タクミノ リョー
偃	フセルノ エン
假	フルイノ カ
會	フルイノ カイ
偕	カイローノ カイ
偐	ニセモノノ ガン
偈	ショーシンゲノ ゲ
做	ゾクジノ ナ
偖	サクノ サテヒラク
偬	イソガシイノ ソー
偸	ヌスビトノ トー
傀	クグツマワシノ カイ
傚	ナラウノ コー
傅	モリヤクノ フ
傴	セムシノ ウ
傲	ゴーゼンタルノ ゴー
僉	センギノ セン
僊	センニンノ セン
傳	ツタエルノ キュージノ デン
僂	クルビョーノ ル
僖	ニンベンニ キノ キ
僞	イツワルノ キュージノ ギ
僥	ギョーコーノ ギョー
僭	センエツナガラノ セン
僣	センエツノ セン
僮	ニンベンニ ワラベノ ドー
價	アタイノ キュージノ カ
僵	タオレルノ キョー
儉	ケンノ キュージノ ケン
儁	スグレルノ シュン
儂	ニンベンニ ノーノ ノー
儖	ニンベンニ カンノ ラン
儕	ナカマノ セイ
儔	チューリョノ チュー
儚	ハカナイノ ハカナ
儡	カイライノ ライ
儺	ニンベンニ ナンノ ダ
儷	ベンレイノ レイ
儼	ゲンゼンタルノ ゲン
儻	スグレルノ トー
儿	ヒトアシノ ジン
兀	ゴツゴツノ ゴツ
兒	コドモノ キュージノ ジ
兌	カタカナノ ハノ シタニ アニノ ヨロコフノ ダ
兔	ゾクジノ ウサギ
兢	センセンキョーキョーノ キョー
竸	キソーノ キョー
兩	リョーノ キュージノ リョー
兪	ナオス ユシュツノ ユノ キュージノ ユ
兮	ジョジノイッシュノ ケイ
冀	ネガウノ キ
冂	エンガマエノ ケイ
囘	マワスノ キュージタイノ カイ
册	サツノ キュージノ サツ
冉	ゼンキューノ ゼン
冏	アキラカノ ケイ
冑	カッチューノ チュー
冓	カマエルノ コー
冕	カンムリノ ベン
冖	ワカンムリノ ベキ
冤	エンザイヲ ハラスノ エン
冦	ゲンコーノ コー
冢	ツカノ チョー
冩	ウツスノ キュージノ シャ
冪	キレノ ベキ
冫	ニスイニヒョーノ ヒョー
决	ニスイニケツノ ケツ
冱	サエルノ サエ
冲	ニスイニナカノ チュー
冰	ニスイニミズノ ヒョー
况	ニスイニキョーノ キョー
冽	リンレツノ レツ
凅	ニスイニカタイノ コ
凉	ニスイニキョーノ リョー
凛	リンリンタルノ リン
几	コシカケショーギノ キ
處	ショノ キュージノ ショ
凩	カゼノ コガラシ
凭	モタレノ モタ
凰	ホーオーノ オー
凵	ウケバコノ カン
凾	ハコノ キュージノ カン
刄	ダイニ ジンノ ヤイバ
刋	ケズルノ セン
刔	エグルノ ケツ
刎	フンケイノマジワリノ フン
刧	ゴーノ ゾクジノ ゴー
刪	ケズルノ サン
刮	ケズルノ カツ
刳	シャクルノ シャク
刹	イッシュンノ セツ
剏	ハジメルノ ソー
剄	リットーニケイノ ケー
剋	ソーコクカンケイノ コク
剌	ハツラツノ ラツ
剞	リットーニキノ キ
剔	テキシュツスルノ テキ
剪	ニワキセンテイノ セン
剴	ガイトーノ ガイ
剩	アマルノ キュージノ ジヨー
剳	リットーニトーノ トー
剿	リットーニスノ ソー
剽	ヒョーキンノ ヒョー
劍	ツルギノノ ケン
劔	ケンノ ゾクジノ ケン
劒	カタナノツルギノ ケン
剱	ツルギノノ ケン
劈	ヘキトーノ ヘキ
劑	クスリノ キュージノ ザイ
辨	ゴーベンカイシャノ ベン
辧	カタナノ ベン
劬	クニチカラノ ク
劭	ツトメルノ ショー
劼	ヨシニチカラノ キチ
劵	ケンノ キュージノ ケン
勁	ユーケイノ ケイ
勍	キョーニチカラノ ケイ
勗	ツトメルノ キョク
勞	ローノ キュージノ ロー
勣	チカラノ セキ
勦	スニチカラノ ソー
飭	タダスノ チョク
勠	アワセルノ リク
勳	イサオノ キュージノ クン
勵	ハゲマスノ キュージノ レイ
勸	ススメルノ キュージノ カン
勹	ツツミガマエノ ホー
匆	ウトソーソーノ ソー
匈	キョードノ キョー
甸	タニツツミガマエノ デン
匍	ホフクゼンシンノ ホ
匐	ホフクゼンシンノ フク
匏	ヒサゴノ ホー
匕	アイクチノ ヒ
匚	ハコガマエノ ホー
匣	パンドラノハコノ コー
匯	イ メグルノ カイ
匱	トボシイノ キ
匳	カガミバコノ レン
匸	カクシガマエノ ケイ
區	クノ キュージノ ク
卆	ソツノ ゾクジノ ソツ
卅	クサノ ソー
丗	ヨノ キュージノ セイ
卉	クサノ キ
卍	マンジドモエノ マンジ
凖	ニスイノシユンノ ジュン
卞	セッカチノ ベン
卩	フシヅクリノ セツ
卮	サカズキノ シ
夘	ウサギノイジノ ボー
卻	シリゾクノ キュージノ キャク
卷	マクノノ カン
厂	ガンダレノ カン
厖	ボーダイノ ボー
厠	カワヤノ シ
厦	カノ ゾクジノ カ
厥	キバミンゾクノ トッケツノ ケツ
厮	シモベノ シ
厰	ショーノ ゾクジノ ショー
厶	ムノ シ
參	マイルノ キュージノ サン
簒	ウバウノ サン
雙	ソーノ キュージノ ソー
叟	オキナノ ソー
曼	マンダラノ マン
燮	ヤワラゲルノ ショー
叮	テイネイノ テイ
叨	ミダリノ トー
叭	ラッパ゚ノ ハ
叺	クチヘンニ ハイルノ カマス
吁	アー ナゲクノ ク
吽	アウンノ ウン
呀	クチヘンニ キバノ ガ
听	ポンドノ ギン
吭	ノドノ コー
吼	ホエルノ コー
吮	ススルノ セン
吶	トツベンノ トツ
吩	クチヘンニ ワケルノ フン
吝	ヤブサカノ ヤブサ
呎	タンイノ フィート
咏	ローエイノ キュージタイノ エイ
呵	シカルノ シカ
咎	トガメルノ トガ
呟	ツブヤクノ ゲン
呱	クチヘンニ ウリノ コ
呷	クチヘンニ コーノ コー
呰	ソシルノ シ
咒	ノロウノ キュージノ ジュ
呻	ウメク シンギンノ シン
咀	ソシャク ウンドーノ ソ
呶	クチヘンニ ヤッコノ ドー
咄	トッサノ バアイノ トツ
咐	クチヘンニ フノ フ
咆	ホーコーノ ホー
哇	ハクノ アイ
咢	オドロクノ キュージノ ガク
咸	ミナノ カン
咥	カムノ キ
咬	カムノ カ
哄	ワライ コーショーノ コー
哈	クチヘンニ ゴーノ コー
咨	ハカルノ シ
咫	タノ シ
哂	クチヘンニ ニシノ シン
咤	クチヘンニ タクノ タ
咾	クチヘンニ ローノ ロー
咼	カノ ケノ カ
哘	クチヘンニ イクノ イク
哥	カノーセイノ カヲ フタツ カサネノ カ
哦	クチヘンニ ワレノ ガ
唏	クチヘンニ マレノ キ
唔	クチヘンニ ゴノ ゴ
哽	クチヘンニ サラノ コー
哮	ホーコーノ コー
哭	アイコクスルノ コク
哺	ホニュールイノ ホ
哢	クチヘンニ オイテノ ロー
唹	クチヘンニ ガイノ ガイ
啀	イガミアウノ イガ
啣	フクムノ ガン
啌	クチヘンニ ソラノ コー
售	ウルノ シュー
啜	ススリナクノ スス
啅	クチヘンニ タクノ タク
啖	ケンタンノ タン
啗	クラウノ タン
唸	ウナルノ テン
唳	フーセイ カクレイノ レイ
啝	クチヘンニ ワノ カ
喙	ヨーカイノ カイ
喀	ハク カッケツスルノ カク
咯	カクノ イジノ カク
喊	サケプ カンセイヲ アゲルノ カン
喟	ナゲクノ キ
啻	ミカドノ シタニ クチ タダニノ シ
啾	ナク クチニ キセツノ アキノ シュー
喘	ゼンソクノ ゼン
喞	ナクノ ソク
單	タンノ キュージノ タン
啼	ナク クチニ ミカドノ テイ
喃	シャベル クチニ ミナミノナン
喩	タトエバナシ ヒユノ ユ
喇	ラッパノ ラ
喨	ホガラカノ リョー
嗚	オエツノ オ
嗅	キューカクノ キュー
嗟	トッサノ バアイノ サ
嗄	カレゴエノ カレ
嗜	シ タシナメルノ タシ
嗤	アザケワラウノ シ
嗔	クチヘンニ マコトノ シン
嘔	オートスルノ オー
嗷	カマビスシイノ ゴー
嘖	クチヘンニ サキノ サク
嗾	ソソノカスノ ソー
嗽	クチヘンノ ウガイ
嘛	クチヘンニ アサノ マ
嗹	クチヘンニ レンノ レン
噎	ムセブノ イツ
噐	フルイノ キ
營	イトナムノ エイ
嘴	クチバシノ イミ クチヘンノ シ
嘶	ダイニ イナナキノ イナナ
嘲	チョーショースルノ チョー
嘸	サゾカシノ サゾ
噫	クチヘン モトノ シタニ ココロノ アイ
噤	ツグムノ ツグ
嘯	クチヘン ウソブクノ ショー
噬	カムノ ゼイ
噪	サワガシイノ ゾクジノ ソー
嚆	コーシノ コー
嚀	クチヘンニ テイノ テイ
嚊	イビキノ ヒ
嚠	リューリョーノ リュー
嚔	クシャミノ テイ
嚏	クシャミノ ゾクジノ テイ
嚥	エンゲノ エン
嚮	ムカウノ コー
嚶	ナクノ オー
嚴	キビシイノ キュージノ ケン
囂	ケンケン ゴーゴーノ ゴー
嚼	ソシャク ウンドーノ シャク
囁	ササヤクノ ササヤ
囃	イイハヤスノ ハヤ
囀	サエズルノ サエズ
囈	タワゴトノ ゲイ
囎	クチヘンニ オクルノ ソ
囑	ショクノ キュージノ ショク
囓	カジルノ キュージノ ゲツ
囗	クニ クニガマエノ イ
囮	クニガマエノ オトリ
囹	クニガマエニ レイノ レイ
圀	ミツクニノ クニノ コク
囿	クニガマエニ アルノ ユー
圄	クニガマエニ ワレノ ゴ
圉	オゴルノ ゴー
圈	ケンノ キュージノ ケン
國	ジンメイ クニヤスノ クニ
圍	カコムノ キュージノ イ
圓	マドカノ キュージノ エン
團	キュージノ ダン
圖	ハカルノ キュージノ ズ
嗇	リンショクノ ショク
圜	マルイノ エン
圦	ツチヘンニ ハイルノ イリ
圷	ツチヘンニ シタノ フクツ
圸	ツチヘンニ ヤマノ ママ
坎	カンセイノ カン
圻	サカイノ キ
址	ツチヘンニ テイシスルノ テイノ シ
坏	トジルノ ハイ
坩	ツボノ カン
埀	タレルノ スイ
垈	カワルニ ツチノ ヌタ
坡	ツツミノ ハ
坿	ツチヘンニ フノ フ
垉	ツチヘンニ ツツムノ ホー
垓	オクノ センバイノ ガイ
垠	ツチヘンニ ゴンノ ゴン
垳	ツチヘンニ イクノ ガケ
垤	ツチヘンニ イタルノ テツ
垪	ツチヘンニ ヘイノ ハ
垰	ツチヘンノ トーゲ
埃	ホコリ ジンアイノ アイ
埆	ツチカクニ カクノ カク
埔	ツチヘンニ ホノ ホ
埒	フラチノ ラチ
埓	ラチナイノ ラチ
堊	シロツチノ ア
埖	ツチヘンニ ハナノ ゴミ
埣	ツチヘンニ ソツノ サイ
堋	フヅチノ ホー
堙	フサグノ イン
堝	ツチヘンニ スギルノ ツクリノ カ
塲	バノ キュージノ ジョー
堡	ダイニ ホルイノ ホ
塢	ツチヘンニ カラ ドテノ ウ
塋	ハカノ エイ
塰	ウミニ ツチノ カイ
毀	メイヨ キソンノ キ
塒	ツチヘンニ トキノ シ
堽	オカノ コー
塹	ザンゴーノ ザン
墅	ノニ ツチノ ヤ
墹	ツチヘンニ アイダノ ママ
墟	オカ ツチヘンニ クーキョノ キョ
墫	ツチヘンニ ソンノ ソン
墺	ツチヘンニ オー オウノ イク
壞	コワレルノ キュージノ カイ
墻	カキネノ ショー
墸	ツチヘンニ チョノ チョ
墮	ナマケルノ キュージノ ダ
壅	フセグノ ヨー
壓	オサエルノ キュージノ アツ
壑	タニノ ガク
壗	ツチヘンニ ツクスノ ママ
壙	ツチヘンニ コーノ コー
壘	ルイノ キュージノ ルイ
壥	ツチヘンニ テンノ テン
壜	ビンヅメノ ビンノ タン
壤	ジョーノ キュージノ ジョー
壟	ツチニ リューノ リュー
壯	ソーノ キュージノ ソー
壺	キュージノ ツボ
壹	イチノ キュージタイノ イチ
壻	ムコノ セイノ ムコ
壼	コンクンクンノ コン
壽	コトブキノ キュージノ ジュ
夂	フユガシラノ チ
夊	スリニョーノ スイ
夐	ハルカノ ケイ
夛	オオイノ キュージノ タ
梦	ユメノ キュージノ ム
夥	オビタダシイノ カ
夬	キメルノ ケツ
夭	ヨーセツノ ヨー
夲	モトノ キュージノ ホン
夸	ホコルノ コ
夾	キョーチクトーノ キョー
竒	キノ ゾクジノ キ
奕	バクチノ エキ
奐	リンカンノ カン
奎	ケイウンノ ケイ
奚	イズクンゾノ ケイ
奘	ソーニ オオキイノ ソー
奢	キャシャナ ヒトノ シャ
奠	タマグシ ホーテンノ テン
奧	キュージノ オク
奬	キュージノ ショー
奩	カガミバコノ レン
奸	ヨコシマノ カン
妁	バイシャクノ シャク
妝	ヨソオウノ ソー
佞	ヨコシマノ ネイ
侫	ヨコシマノ イジノ ネイ
妣	ナキハハノ ヒ
妲	ダツキノ ダツ
姆	オンナヘンニ ナワノ バ
姨	オンナヘンノ ウバ
姜	ショーガノ ガ
妍	ウツクシイノ ケン
姙	ハラムノ イジノ ニン
姚	ヨーコーノ ヨー
娥	オンナヘンニ ワレノ ガ
娟	シナヤカ エンノ ケン
娑	シャバノ シャ
娜	シナヤカノ ダ
娉	メトルノ ヘイ
娚	オンナニ オトコノ ナン
婀	オンナヘンノ ア
婬	タノシムノ キュージノ イン
婉	エンゼンノ エン
娵	オンナヘンニ トルノ シュ
娶	ツマヲ メトルノ メト
婢	ゲジョノ ヒ
婪	ドンランノ ラン
媚	コビルノ コ
媼	オウナノ オー
媾	イツクシムノ コー
嫋	タオヤカノ タオ
嫂	オンナヘンノ ソー
媽	オンナヘンニ ウマノ ボ
嫣	エンゼンノ エン
嫗	オウナノ オー
嫦	オンナヘンニ ツネノ コー
嫩	オンナヘンニ タバノ ミギニ ノブンノ ワカ
嫖	フサグノ イン
嫺	ミヤビヤカノ カン
嫻	カンノ イジノ カン
嬌	ナマメカシイノ キョー
嬋	センケンノ セン
嬖	カベノ ツチノ カワリニ オンナノ ヘイ
嬲	ナブリモノノ ナブ
嫐	オンナノ ナブルノ ジョー
嬪	ヒメノ ヒン
嬶	オンナヘンニ ハナノ カカア
嬾	オコタル オンナヘンニ ライノ ラン
孃	ムスメノ キュージノ ジョー
孅	オンナヘン カヨワイノイミノ セン
孀	ヤモメノ ソー
孑	ヒトリノ イミノ ゲツ
孕	ハラムノ ヨー
孚	タマゴノ フ
孛	ホーキボシノ ハイ
孥	オンナヘン ツマコノ ド
孩	ミドリノ ガイ
孰	イズレノ ジュク
孳	シゲルノ ジ
孵	タマゴガフカスルノ フ
學	ダイニ ダイガクノ ガク
斈	マナブノ ゾクジノ ガク
孺	ジュシノ ジュ
宀	ブシュノ ウカンムリノ ベン
它	ホカノ タ
宦	カンガンノ カン
宸	シンピツノ シン
寃	ウラミノ ゾクジノ エン
寇	アダノ ゾクジノ コー
寉	アガルノ カク
寔	マコトノ ショク
寐	ネルノ ビ
寤	サメルノ ゴ
實	ミノルノ キュージノ ジツ
寢	ネルノ キュージノ シン
寞	セキバクノ バク
寥	サビシイノ リョー
寫	キュージノ シャ
寰	ヨノナカ ジンカンノ カン
寶	タカラノ キュージノ ホー
寳	タカラノ ゾクジノ ホー
尅	カツノ コク
將	キュージノ ショー
專	ダイニ モッパラノ セン
對	キュージノ タイ
尓	ニノ リャクジノ ジ
尠	スクナイノ セン
尢	マゲアシノ オー
尨	ムクゲノ ムク
尸	カバネノ シ
尹	オサノ イン
屁	オナラノ ヘ
屆	トドケルノ キュージノ カイ
屎	メクソノ クソ
屓	ヒイキノ イキ
屐	ハキモノノ ケキ
屏	ビョーブノ ビョー
孱	ヨロイノ セン
屬	ゾクノ キュージノ ショク
屮	テツノ テツ
乢	ヤマニツリバリノ ガイ
屶	ヤマニカタナノ ナタ
屹	ソビエルニキツノ キツ
岌	ヤマニオヨブノ キュー
岑	ミネノ シン
岔	フンニヤマノ タ
妛	ヤマニオンナノ シ
岫	ミネノ シュー
岻	ヤマノナマエノ ヂ
岶	ヤマヘンニ シロノ ハク
岼	ヤマヘンニ タイラノ ユリ
岷	ビンザンノ ビン
峅	ヤマヘンニ ベンノ クラ
岾	ヤマヘンニ センノ セン
峇	ヤマニアウノ コー
峙	ヤマヘンニ テラノ ジ
峩	ヤマニワレノ ガ
峽	ハザマノイジノ キョー
峺	ヤマヘンニ サラノ コー
峭	シュンカンリョーショーノ ショー
嶌	シマノ ゾクジノ トー
峪	ヤマヘンニ タニノ ヨク
崋	カザンノ カ
崕	ガケノ ガイ
崗	カコーガンノ コー
嵜	ミサキノ ゾクジノ キ
崟	ヤマニキンノ ギン
崛	ソバダツノ クツ
崑	ヤマノハ ヤマカンムリニ コンチューノ コン
崔	ヤマニフルトリノ サイ
崢	ソーコーノ ソー
崚	ヤマヘンニ リョーノ リョー
崙	ヤマカンムリニ ギロンスルノ ロン
崘	ロンノイジノ ロン
嵌	アテハマルノ ハマ
嵒	イワノ ガン
嵎	ヤマヘンニ グーノ グー
嵋	ヤマヘンニ ビノ ビ
嵬	ヤマニオサノ カイ
嵳	ヤマニサノ サ
嵶	ヤマヘンニ ヨワリノ タオ
嶇	ヤマヘンニ クノ ク
嶄	ザンゼンノ ザン
嶂	ヤマヘンニ ショーノ ショー
嶢	ヤマヘンニ ギョーノ ギョー
嶝	ヤマヘンニ ノボルノ トー
嶬	ヤマヘンニ ギノ ギ
嶮	ケワシイノ ケン
嶽	キュージ サンガクノ ガク
嶐	ヤマニタカシノ リュー
嶷	ヤマニータガウノ ギ
嶼	シマノ ショ
巉	サンガンノ サン
巍	ギゼンノ ギ
巓	イタダキノ テン
巒	ランポーノ ラン
巖	キュージ イワオノ ガン
巛	カワノ セン
巫	フザケルノ フ
已	ヤメルノ イ
巵	イタイジ サカズキノ シ
帋	カミノイタイジノ シ
帚	ホーキボシノホーキノ ソー
帙	フミヅツミノ テツ
帑	カネイレノ ド
帛	チクハクノコーノ ハク
帶	ダイニ オビノ タイ
帷	ハバヘンニ フルトリノ イ
幄	トバリノ アク
幃	ハバヘンニ ナメシガワノ イ
幀	セイホンノ テイ
幎	カオカクシノ ベキ
幗	ハバヘンニ クイノ カク
幔	マンマクノ マン
幟	コイノボリノ ノボリ
幢	ハタノ トー
幤	ヌサノ キュージノ ヘイ
幇	ホーカンノ ホー
幵	タイラノ ケン
并	アワセルノ ヘイ
幺	イトガシラノ ヨー
麼	イカニノ マ
广	マダレノ ゲン
庠	マダレニヒツジノ ショー
廁	カワヤノ シ
廂	マダレノヒサシノ ショー
廈	タイカコーローノ カ
廐	ウマヤジノ キュー
廏	カイヨーハンコンノ ハン
廖	マダレニリョーノ リョー
廣	ジンメイ ヒロカワノ ヒロ
廝	コモノノ シ
廚	クリヤノイジノ チュー
廛	ミセノ テン
廢	スタレルノ キュージノ ハイ
廡	マダレニナシノ ブ
廨	マダレニトクノ カイ
廩	クラノ リン
廬	ロザンノ ロ
廱	ヤワラグノ ヨー
廳	チョーノ キュージノ チョー
廰	マダレニキクノ チョー
廴	ヒクノ イン
廸	ジンメイ ヨシニエンニョーノ ミチ
廾	ニジューアシノ キョー
弃	ステルノ ゾクジノ キ
弉	ソーノ キュージノ ソー
彝	ツネノ イ
彜	ツネノ イ
弋	ユーヨクノ ヨク
弑	コロスノ シ
弖	ユミニイチノ テ
弩	チョードキューノ ド
弭	ヤメルノ ビ
弸	ユミヘンニ ホーノ ホー
彁	ユミヘンニ カノ カ
彈	ヒクリノ キュージノ ダン
彌	ジュンヤノ ヤ
彎	コーワンノ ワン
弯	ソクワンノ ワン
彑	ケイガシラノ ケイ
彖	タンジノ タン
彗	ホーキボシノ スイ
彙	ボキャブラリーノノ イ
彡	サンヅクリノ サン
彭	ツヅミノオトノ ホー
彳	ギョーニンベンノ テキ
彷	スイテンホーフツノ ホー
徃	ユクノ ゾクジノ オー
徂	オギューソライノ ソ
彿	スイテンホーフツノ フツ
徊	ハイカイノ カイ
很	ハナハダノ コン
徑	コミチノ キュージノ ケイ
徇	トナエルノ ジュン
從	シタガウノ キュージノ シュー
徙	ウツルノ シ
徘	ハイカイノ ハイ
徠	クルノコジノ ライ
徨	ホーコーノ コー
徭	ブヤクノ ヨー
徼	モトメルノ キョー
忖	ソンタクノ ソン
忻	リッシンベンニ キンノ キン
忤	サカラウノ ゴ
忸	ジクジノ ジク
忱	マゴコロノ シン
忝	カタジケナイノ テン
悳	ノリノ トク
忿	オコルノ フン
怡	ヨロコブノ イ
恠	アヤシイノ イ
怙	エコヒイキノ コ
怐	リッシンベンニ クノ ク
怩	ジクジノ ジ
怎	イカデノ シン
怱	ニカワノ ソー
怛	イタムノ タン
怕	オソレルノ ハク
怫	イカルノ フツ
怦	リッシンベンニ ヘイノ ホー
怏	リッシンベンニ オーノ オー
怺	コラエルノ エイ
恚	イカルノ イカ
恁	ニンモノ ニン
恪	セイレンカッキンノ カク
恷	ヤスムニコノ コロ
恟	カマビスシイノ キョー
恊	フルイノ キョー
恆	ツネノ キュージノ コー
恍	コーコツノヒトノ コー
恣	ホシイママノ シ
恃	タノムノ シ
恤	アワレムノ ジュツ
恂	マコトノ シュン
恬	キョセイテンタンノ テン
恫	ドーカツノ ドー
恙	ツツガナクノ ツツガ
悁	イキドオルノ エン
悍	ヒョーカンノ カン
惧	キグノネンヲ イダクノ グ
悃	コンポーノ コン
悚	オソレルノ ショー
悄	ショーゼンタリノ ショー
悛	アラタメルノ シュン
悖	モトルノ ハイ
悗	リッシンベンニ メンノ バン
悒	ウレエルノ ユー
悧	カシコイノ リ
悋	リンキノ リン
惡	ワルイノ キュージノ アク
悸	ドーキガスルノ キ
惠	ダイニ メグムノ ケイ
惓	ウムノ ケン
悴	ヤツレルノ スイ
忰	ショースイノ スイ
悽	セイサンノ セイ
惆	ウラムノ チュー
悵	チョーコンノ チョー
惘	ボーボーノ ボー
慍	イカルノ オン
愕	ガクゼントノ ガク
愆	アヤマルノ ケン
惶	キョーコーキンゲンノ コー
惷	オロカノ シュン
愀	リッシンベンニ アキノ ショー
惴	オソレルノ ズイ
惺	リッシンベンニ ホシノ セイ
愃	リッシンベンニ センノ ケン
愡	リッシンベンニ ソーノ ソー
惻	ソクインノ ソク
惱	ナヤムノ キュージノ ノー
愍	アワレムノ ミン
愎	モトルノ フク
慇	インギンブレイノ イン
愾	テキガイシンノ ガイ
愨	マコトノ カク
愧	ザンキノ キ
慊	アキタラナイノ ケン
愿	ツツシムノ ゲン
愼	ツツシムノ キュージノ シン
愬	ウッタエルノ サク
愴	ヒソーノ ソー
愽	ミャクハクノ ハク
慂	ショーヨーノ ヨー
慄	オカンセンリツノ リツ
慳	ジャケンナヒトノ ケン
慷	ヒフンコーガイノ コー
慘	ミジメノ キュージノ サン
慙	ハカイムザンノ ザン
慚	ザンキノ ザン
慫	ショーヨーノ ショー
慴	オソレルノ ショー
慯	リッシンベンニ キズノ ショー
慥	タシカノ ゾー
慱	ウレエルノ タン
慟	ドーコクスルノ ドー
慝	ケガレルノ トク
慓	リッシンベンニ ヒョーノ ヒョー
慵	モノーイノ ヨー
憙	ヨロコブニコノ コロ
憖	シバラクノ ギン
憇	イコーノ ゾクジノ ケイ
憬	アコガレノノ ケイ
憔	ヤツレルノ ショー
憚	ハバカルノ タン
憊	ヒローコンパイノ ハイ
憑	シンピョーセイノ ヒョー
憫	レンビンノ ビン
憮	ブゼンノ ブ
懌	ヤクノ エキ
懊	ヤナムノ オー
應	ケイオーダイガクノ オー
懷	キュージ フトコロノ カイ
懈	ゲタイノ ゲ
懃	インギンブレイノ ギン
懆	リッシンベンニ ソーノ ソー
憺	リッシンベンニ タンノ タン
懋	ツトメルノ ボー
罹	リカンスルノ リ
懍	オソレルノ リン
懦	キノヨワイイミノ ダ
懣	フンマンノ マン
懶	ランダノ ラン
懺	ザンゲノ ザン
懴	クイルノ ザン
懿	ホメルノ イ
懽	ヨロコブノ カン
懼	クゼンノ ク
懾	オソレルノ ショー
戀	コイノ キュージノ レン
戈	ホコノ カ
戉	ダイニスイジュンノ マサカリ
戍	マモリノ ジュ
戌	エトノ イヌ
戔	ソコナウノ サン
戛	コスルノ カツ
戞	カツノ ゾクジノ カツ
戡	コロスノ カン
截	ゾクニ チョクサイトヨム チョクセツノ セツ
戮	タツリクノ リク
戰	タタカウノ キュージノ セン
戲	タワムレノ キュージノ ギ
戳	サスノ タク
扁	ヒラタイ ヘントーセンノ ヘン
扎	テヘンニ ツリバリノ サツ
扞	フセグ テヘンニ ホスノ カン
扣	タタク テヘンニ クチノ コー
扛	テヘンニ タクミノ コー
扠	テヘンニ アナノ ナカニ テンノ サ
扨	テヘンニ ヤイバノ サテ
扼	オサエル テヘンニ ヤクドシノ ヤク
抂	テヘンニ オーノ キョー
抉	コジハナツノ コ
找	サガスノ ソー
抒	ジョジョーノ ジョ
抓	ツマムノ ソー
抖	トソーノ ト
拔	ヌクノ キュージノ バツ
抃	ウツノ ベン
抔	ホードノ ホー
拗	スネルノ ス
拑	ツグムノ カン
抻	テヘンニ モースノ シン
拏	トラエルノ ダ
拿	ダホスルノ ダ
拆	ヒラクノ タク
擔	ニナウノ キュージノ タン
拈	レンゲミショーノ レン
拜	オガムノ キュージノ ハイ
拌	カクハンノ ハン
拊	ナデルノ フ
拂	ハラウノ キュージノ フツ
拇	ボシノ ボ
抛	ナゲステルノ ホー
拉	ウチヒシガレルノ ヒシ
挌	ウツノ カク
拮	キッコースルノ キツ
拱	テヲ コマネクノ キョー
挧	テヘンニ ワノ ウ
挂	カケルノ ケイ
挈	ヒッサゲルノ ケツ
拯	タスケルノ ジョー
拵	コシラエルノ コシラ
捐	ギエンキンノ エン
挾	キョーゲキノ キョーノ ハサ
捍	フセグノ カン
搜	サガスノ キュージノ ソー
捏	ネツゾースルノ ネツ
掖	タスケルノ エキ
掎	テヘンニ メズラシノ キ
掀	アゲルノ キン
掫	テヘンニ トルノ シュ
捶	ムチウツノ スイ
掣	セイチューノ セイ
掏	エラブノ トー
掉	チョービノ チョー
掟	オキテヤブリノ オキテ
掵	テヘンニ イノチノ ハバ
捫	ヒネルノ モン
捩	ネジルノ レツ
掾	テンダイノヒツノ テン
揩	カイショノ カイ
揀	エラブノ カン
揆	イッコーイッキノ キ
揣	シマノ シ
揉	モム ジューネツスルノ ジュー
插	サスノ キュージノ ソー
揶	ヤユノ ヤ
揄	ヤユノ ユ
搖	ユレルノ キュージノ ヨー
搴	トルノ ケン
搆	カマエルノ コー
搓	テヘンニ サノ サ
搦	カラメルノ ジャク
搶	テヘンニ クラノ ソー
攝	セッセイスルノ セツ
搗	モチヲ ツク テヘンニ シマノ トー
搨	スルノ トー
搏	シンパクスーノ ハク
摧	クダクノ サイ
摯	シンシナノ シ
摶	ウツノ タン
摎	ククルノ コー
攪	ミダスノ キュージノ カク
撕	テヘンニ シノ セイ
撓	タワメルノ トー
撥	シャミセンノ バチ
撩	ヒャッカリョーランノ リョー
撈	トルノ ロー
撼	フルエウゴク シンカンノ カン
據	ヨルノ キュージノ キョ
擒	トリコノ キン
擅	ホシイママノ セン
擇	エラブノ キュージノ タク
撻	ベンタツノ タツ
擘	ツンザクノ ハク
擂	スリコギノ ス
擱	カクヒツスルノ カク
擧	アゲルノ キュージノ キョ
舉	アゲルノイジノ キョ
擠	オスノ セイ
擡	モタゲルノ モタ
抬	モタゲルノダイノ タイ
擣	ウツノ トー
擯	シリゾケルノ ヒン
攬	トルノ ラン
擶	タダスノ セン
擴	ヒロゲルノ キュージノ カク
擲	ケンコンイッテキノ テキ
擺	ヒラクノ ハイ
攀	ヨジノボルノ ハン
擽	ウツノ リャク
攘	リュージョーコハクノ ジョー
攜	タズサエルノ キュージノ ケイ
攅	アツマルノ サン
攤	ヒラクノ タン
攣	ケイレンノ レン
攫	イッカク センキンノ カク
攴	トマタノ ボク
攵	ノブンノ ボク
攷	カンガエルノコジノ コー
收	オサメルノ キュージノ シュー
攸	トコロノ ユー
畋	タニノブンノ テン
效	キクノ キュージノ コー
敖	アソブノ ゴー
敕	イマシメノ キュージノ チョク
敍	ノベルノ セイジノ ジョ
敘	ノベルノ キュージノ ジョ
敞	ヒラケルノ ショー
敝	ヤブレルノ ヘイ
敲	スイコースルノ コー
數	カズノ キュージノ スー
斂	シューレンノ レン
斃	ヘイシノ ヘイ
變	カワルノ キュージノ ヘン
斛	ツノヘンニ トノ コク
斟	シンシャクノ シン
斫	キルノ シャク
斷	タツノ キュージノ ダン
旃	センダンノ セン
旆	ハタノ ハイ
旁	ツクリ キューボーケッセツノ ボー
旄	ボーギューノ ボー
旌	ハタノ セイ
旒	ナガレノ リュー
旛	インバグンノ バ
旙	ハタノ ハン
无	ナイノコジノ ム
旡	スデノツクリノ キ
旱	カンバツニミマワレルノ カン
杲	アキラカノ コー
昊	ソラノ コー
昃	カタムクノ ソク
旻	ソラノ ビン
杳	ヨートシテノ ヨー
昵	チカヅクノ ジツ
昶	ヒサシイノ チョー
昴	スバルノ ボー
昜	コザトナシノ ヨー
晏	アンシシュンジューノ アン
晄	ヒカルノ キュージノ コー
晉	ススムノ セイジノ シン
晁	セイノヒトツノ チョー
晞	カワクノ キ
晝	ヒルノ キュージノ チュー
晤	ヒヘンニ ワリノ ゴ
晧	ヒヘンニ ツゲルノ コー
晨	ヒンケイアシタスノ アシタ
晟	アキラカノ セイ
晢	アキラカノ セキ
晰	ズノーメイセキノ セキ
暃	ヒニアラズノ ヒ
暈	メマイノ ウン
暎	ヒヘンノエイ ハエルノ エイ
暉	カガヤクノ キ
暄	アタタカノ ケン
暘	ヒノデノ ヨー
暝	ヤミノ メイ
曁	オヨビノ キ
暹	ススムノ セン
曉	アカツキノ キュージノ ギョー
暾	ヒヘンニ トンノ トン
暼	イチベツノ ベツ
曄	カガヤクノ ヨー
暸	アキラカノイジノ リョー
曖	アイマイノ アイ
曚	モーマイノ モー
曠	コージツビキューノ コー
昿	コーノ リャクジノ コー
曦	タイヨーノ ギ
曩	サキニノ ノー
曰	カレイワクノ イワ
曵	ダイニ エイコースルノ エイ
曷	イズクンゾノ カツ
朏	ミカヅキノ ヒ
朖	ホガラカノ キュージノ ロー
朞	ゴュージノ キ
朦	イシキモーローノ モー
朧	オボロヅキヨノ オボロ
霸	ハタガシラノ キュージノ ハ
朮	ウケラノ ジュツ
朿	トゲノ シ
朶	ミミタブノ タブ
杁	キヘンニ ハイルノ イリ
朸	キヘンニ チカラノ リョク
朷	キヘンニ カタナノ トー
杆	カンジョータイノ カン
杞	キユーノ キ
杠	テコノ コー
杙	クイノ ヨク
杣	キヘンニ ヤマノ ソマ
杤	キノイジノ トチ
枉	オーガノ オー
杰	ケツノ ゾクジノ ケツ
枩	キノマツノイジノ ショー
杼	ハタオリキノ ヒ
杪	コズエノ ビョー
枌	キヘンニ ワケルノ フン
枋	シャボートクノ ボー
枦	キヘンニ トノ ロ
枡	イッショーマスノ ショー
枅	キヘンニ ケイノ ケイ
枷	アシカセノ カセ
柯	ランカノ カ
枴	ツエノ カイ
柬	エラブノ カン
枳	キノカラタチノ キ
柩	ヒツギノ キュー
枸	キノケンボナシノ ク
柤	キノコボケノ サ
柞	キノ サク
柝	ヒョーシギノ タク
柢	ネノ テイ
柮	キヘンニ デルノ トツ
枹	キノ ホー
柎	キヘンニ ツクノ フ
柆	キヘンニ タツノ リュー
柧	ザイモクノ ツマ
檜	ゾクジノ ヒノキ
栞	シオリ ノ シオリ
框	カマチノ キョー
栩	クヌギノ トチ
桀	ケッチューノ ケツ
桍	キヘンニ ハカマノ コ
栲	キヘンニ コーノ コー
桎	キヘンニ イタルノ シツ
梳	ソノ クシケズ
栫	キヘンニ ソンノ セン
桙	ミズノミノ ウ
档	キヘンニ アタルノ トー
桷	キヘンニ ツノノ タルキ
桿	カンキンルイノ カン
梟	フクローノ キョー
梏	イビキノ カン
梭	ハタオリキノ ヒ
梔	キノクチナシノ シ
條	スジノ キュージノ ジョー
梛	キノナギノ ダ
梃	キヘンノ テイ
檮	キリカブノ キュージノ トー
梹	キヘンニ ヘイノ ビン
桴	タイコノ バチ
梵	ボンゴノ ボン
梠	キヘンニ ロノ リョ
梺	ハヤシニシタノ フモト
椏	キヘン マタノ ア
梍	カマノエノ アウ
桾	キヘンニ キミノ クン
椁	ヒツギノ カク
棊	ナゴヤノキシメンノ キ
椈	キヘンニ キクノ キク
棘	キョクトッキノ キョク
椢	キヘンニ クニノ カク
椦	キヘンニ ケンノ ケン
棡	キヘンニ オカノ コー
椌	キヘンニ ソラノ コー
棍	コンボーノ コン
棔	キヘンニ コンノ コン
棧	サンバシノ サン
棕	シュロノ シュ
椶	シュノイジノ シュ
椒	ハジカミノ ショー
椄	ツグノ セツ
棗	ナツメノノ ソー
棣	ニワウメノ テイ
椥	ナギノツジノ ナギ
棹	ウメサオタダオノ サオ
棠	サドーノフネノ ドー
棯	キヘンニ ネンノ ニン
椨	キヘンニ フノ トー
椪	キヘンニ ナラブノ クヌギ
椚	キヘンニ モンガマエノ クヌギ
椣	キヘンニ テンノ シデ
椡	キヘンニ イタルノ トー
棆	クスノキノタグイノ リン
楹	ヨーノ エイ
楷	カイショタイノ カイ
楜	キヘンニ コノ コ
楸	キヘンニ アキノ シュー
楫	カジノ シュー
楔	クサビガタノ クサビ
楾	キヘンニ イズミノ ハンゾー
楮	キヘンニ モノノ コーゾ
椹	キノサワラノ ジン
楴	キヘンニ テイノ テイ
椽	タルキノ テン
楙	サカエルノ ボー
椰	ヤシノ ヤ
楡	キノ ニレノ ユ
楞	リョーガノ ガノ リョー
楝	オウチノ キノ レン
榁	キヘンニ シツノ ムロ
楪	キヘンニ ワノ ヨー
榲	キヘンニ オンノ オン
榮	サカエルノ キュージノ エイ
槐	キンカイワカシューノ カイ
榿	ハンノキノ ガイ
槁	キヘンニ タカイノ コー
槓	テコノ コー
榾	キヘンニ ホネノ コツ
槎	キヘンニ サノ サ
寨	トリデノ サイ
槊	ホコノ サク
槝	キヘンニ シマノ カシ
榻	コシカケノ トー
槃	ネハンギョーノ ハン
榧	キノカヤノ ヒ
樮	キニケムリノ ホクソ
榑	フシクレダツノ クレ
榠	キヘンニ メイノ ベイ
榜	ヒョーボーイノ ボー
榕	キヘンニ ヨーノ ヨー
榴	ツツジガオカノ ツツジ
槞	キヘンニ タツノ リュー
槨	ヒツギノ カク
樂	タノシイノ キュージノ ラク
樛	マガルノ キュー
槿	キノムクゲノ キン
權	ケンノ キュージノ ケン
槹	キヘンニ コーノ コー
槲	キノカシワノ コク
槧	フダノ ゼン
樅	モミノキノ モミ
榱	キヘンニ オトロエノ スイ
樞	カナメノ キュージノ スー
槭	カエデノタグイノ シュク
樔	キヘンニ スノ ソー
槫	ヒツギシャノ タン
樊	トリカゴノ ハン
樒	キヘンニ ミツノ ミツ
櫁	ミツノイジノ ミツ
樣	サマノ キュージノ ヨー
樓	ヤグラノ キュージノ ロー
橄	キヘンニ カンノ カン
樌	キヘンニ ツラヌクノ カン
橲	キヘンニ ヨロコブノ ズサ
樶	キヘンニ サイノ サイ
橸	キヘンニ ショーノ ショー
橇	ユキゾリノ ソリ
橢	ダエンノ キュージノ タイ
橙	ダイダイノ トー
橦	シュモクノ シュ
橈	ドー トーコツノ トー
樸	ボクジツノ ボク
樢	クサノナマエノ ツタ
檐	エンガノ エン
檍	キノナマエノ モチ
檠	トモシビノ ケイ
檄	ゲキブンノ ゲキ
檢	ケンエツノ ケン
檣	ホバシラノ ショー
檗	キハダノ ハク
蘗	ハクノイジノ ハク
檻	セッカンスルノ カン
櫃	ハコ コメビツノ ヒツ
櫂	カジ トーカノ トー
檸	ドーモーノ ドー
檳	ビンロージュノ ビン
檬	レモンノ モン
櫞	クエンサンノ エン
櫑	タルノ ライ
櫟	クヌギノ レキ
檪	レキノイジノ レキ
櫚	シュロノノ カリン
櫪	キヘンニ レキノ レキ
櫻	キュージノ サクラ
欅	キヘンニ センキョノ キョノ ケヤキ
蘖	ハクノイジノ ハク
櫺	レンジノ レイ
欒	イッカダンランノ ラン
欖	キヘンニ ランノ ラン
鬱	ウツビョーノ ウツ
欟	キノ ツキ
欸	ナゲクノ アイ
欷	ススリナクノ キ
盜	ヌスムノ キュージノ トー
欹	ソバダツノ ソバダ
飮	ノムノ キュージタイノ イン
歇	カンケツネツノ ケツ
歃	ススルノ ソー
歉	アキタラナイノ ケン
歐	ハクノ キュージノ オー
歙	キューキョクノ キュー
歔	ススリナクノ キョ
歛	ノゾムノ カン
歟	ヨノ カ
歡	ヨロコブノ キュージノ カン
歸	カエルノ キュージノ キ
歹	シヌノ ガツ
歿	ナクナルノ ボツ
殀	ワカジニノ ヨー
殄	ツクスノ テン
殃	ヨオーノ オー
殍	イチタヘンニ フノ ヒョー
殘	ノコルノ キュージノ ザン
殕	クサルノ フー
殞	シヌノ イン
殤	ワカジニノ ショー
殪	タオスノ アイ
殫	ツクスノ タン
殯	ヒンキューノ ヒン
殲	センメツスルノ セン
殱	ホロボスノ セン
殳	ルマタノ シュ
殷	インキョノ イン
殼	フルイノ カク
毆	ナグルノ キュージノ オー
毋	ナガレノ ブ
毓	カオルノ イク
毟	クサヲ ムシルノ ムシ
毬	ケマリノ カエジノ キュー
毫	キゴーノ ゴー
毳	ムクゲノ ケバ
毯	モーセンノ タン
麾	キカノ キ
氈	シキモノノ セン
氓	ゴーゾクノ ゴー
气	キガマエノ キ
氛	ワザワイノ フン
氤	インウンノ イン
氣	キュージ キブンノ キ
汞	ショーコースイノ コー
汕	サンサンノ サン
汢	サンズイニツチノ ト
汪	サンズイニオーノ オー
沂	セキスイノ セキ
沍	ゴカノ ゴ
沚	サンズイニトメルノ ナギサ
沁	シミルノ シン
沛	ゾージテンパイノ ハイ
汾	フンスイノ フン
汨	ベキラノ ベキ
汳	サンズイニハンノ ヘン
沒	ボツノイジノ ボツ
沐	シップーモクーノ モク
泄	ハイセツブツノ セツ
泱	サンズイニオーノ オー
泓	ミズタマリノ オー
沽	コケンニカカワルノ コ
泗	ナミダノ シ
泅	サンズイニシューノ シュー
泝	サカノボルノ ソ
沮	ハバムノ ショ
沱	イケノ ダ
沾	ウルオウノ テン
沺	サンズイニタノ テン
泛	サンズイニボーノ ボー
泯	ホロビルノ ミン
泙	サンズイニタイラノ ホー
泪	ナミダノイジノ ルイ
洟	ハナタレノ ハナ
衍	ハビコル フエンノ エン
洶	ワクノ キョー
洫	ミゾノ キョク
洽	アマネノ コー
洸	サンズイニヒカリノ コー
洙	サンズイニシュノ シュ
洵	マコトノ ジュン
洳	サンズイニニョノ ジョ
洒	シャレノ シャ
洌	サンズイニレツノ レツ
浣	カンチョースルノ カン
涓	ケンジンノ ケン
浤	サンズイニヒロシノ コー
浚	サラウノ サラ
浹	アマネシノショーノ ショー
浙	サンズイニオルノ セツ
涎	ズイエンノ エン
涕	ナミダノ テイ
濤	ナミノ キュージノ トー
涅	ネハンギョーノ ネ
淹	ハンチューエンノ エン
渕	サンズイノ フチ
渊	ツチノ キュージノ エン
涵	ヒタスノ カン
淇	キスイノ キ
淦	サンズイニキンノ カン
涸	ミズガノ カレ
淆	ギョクセキコンコーノ コー
淬	サイレイノ サイ
淞	サンズイニマツノ ショー
淌	オオナミノ ショー
淨	キヨイノ キュージノ ジョー
淒	スゴイノイジノ セイ
淅	サンズイニ ブンセキノ セキノ セツ
淺	アサイノ キュージノ セン
淙	ソゾクノ ソー
淤	ドロノ オ
淕	サンズイノ リク
淪	リンラクノ リン
淮	エナンジノ エ
渭	サンズイニ イブクロノ イノ イ
湮	ショーコインメツノ イン
渮	サンズイノ カ
渙	カンサンノ カン
湲	キヨイノ エン
湟	サンズイニコーノ コー
渾	キョコンノ コン
渣	チンサノ サ
湫	サンズイニアキノ シュー
渫	シュンセツノ セツ
湶	サンズイニイヅミノ セン
湍	ハヤセノ タン
渟	トドマルノ テイ
湃	サンズイニオガムノ ハイ
渺	サンズイ ヒョービョーノ ビョー
湎	サンズイニメンノ メン
渤	チメイ ボッカイノ ボツ
滿	ミツルノ キュージノ マン
渝	カワルノ ユ
游	リクユーノ ユー
溂	ハツラツノ ラツ
溪	タニノ キュージノ ケイ
溘	タチマチノ コー
滉	ヒロイノ コー
溷	イシキコンダクノ コン
滓	コーサイノ サイ
溽	ムシアツイノ ジョク
溯	サカノボルノ サカノボ
滄	サンズイニクラノ ソー
溲	サンズイニソーノ ソー
滔	トートートナガレルノ トー
滕	クニノナノ トー
溏	イケノ トー
溥	フテンノ フ
滂	ボーヨーノボーノ ホー
溟	クライノ メイ
潁	ヨーノ エイ
漑	カンガイヨースイノ ガイ
灌	ダイニノカンボクノ カン
滬	シャハイノイメイノ コ
滸	オコガマシイノ コ
滾	タギルノ コン
漿	ショーショーケツノ ショー
滲	ニジム シンシュツノ シン
漱	ナツメソーセキノ ソー
滯	タイノ キュージノ タイ
漲	ミナギルノ ミナギ
滌	アラウノ テキ
漾	タダヨーノ ヨー
漓	ボッコンリンリノ リ
滷	サンズイニハノ ロ
澆	ウスイノ ギョー
潺	センリューノ セン
潸	サンゼンノ サン
澁	シブイノイジノ ジュー
澀	シブイノ キュージノ ジュー
潯	ジンヨージンノ ジン
潛	モグクルノ キュージノ セン
濳	モグルノイジノ セン
潭	フカイノ タン
澂	スムノ チョー
潼	サンズイニドーノ トー
潘	シロミズノ ハン
澎	サンズイニホーノ ホー
澑	タマルノ キュージノ リュー
濂	ウスイノ レン
潦	タマリミズノ ロー
澳	サンズイニオクノ オク
澣	サンズイニミキノ カン
澡	アラウノ ソー
澤	ダイニ キュージノ サワ
澹	アンタンタルモノノ タン
濆	サンズイニフンノ フン
澪	ミオツクシノノ レイ
濟	スムノ キュージノ サイ
濕	シメルノ キュージノ シツ
濬	サラウノ シュン
濔	ビイノ ビ
濘	ヌカルミノ ネイ
濱	ヒン キュージノ ハマ
濮	サンズイニボクノ ボク
濛	モーモーノ モー
瀉	ホシャゲイズイノ シャ
瀋	シンヨーノ シン
濺	ソソグノ セン
瀑	バクジョーイノ バク
瀁	サンズイニヨーノ ヨー
瀏	ホガラカノ リュー
濾	ロカスルノ ロ
瀛	ヨーノ エイ
瀚	カンカイノ カン
潴	サンズイニチョノ チョ
瀝	ヒレキノ レキ
瀘	ロスイノ ロ
瀟	キヨイノ ショー
瀰	ビマンセイノ ビ
瀾	キョーランドトーノ ラン
瀲	サンズイニレンノ レン
灑	シャラクノ サイ
灣	キュージ イリエノ ワン
炙	アブルノ アブ
炒	マメヲ イルノ イ
炯	ケイガンノ ケイ
烱	ケイノ ゾクジノ ケイ
炬	コタツノ コ
炸	サクレツスルノ サク
炳	アキラカノ ヘイ
炮	アブルノ ホー
烟	ケムリノ キュージタイノ エン
烋	ヤスムニヨツテンノ キュー
烝	ススメルノジョーノ ジョー
烙	ラクインノ ラク
焉	オワリ シューエンノ エン
烽	ホーカノ ホー
焜	ガスコンロノ コン
焙	ホージルノ ホー
煥	サイキカンパツノ カン
煕	キ ヒカルイミノ ヒロ
熈	キノイジノ キ
煦	アタタカノ ク
煢	ヒトリノ ケイ
煌	キラメクノ コー
煖	ダンロノ ダン
煬	アブルノ ヨー
熏	イブスノ クン
燻	イカノノ クン
熄	キエルノ ソク
熕	ヒヘンニ ミツグノ コー
熨	オサエルノ イ
熬	イルノ ゴー
燗	サケノカンノ カン
熹	カスカナノ キ
熾	シレツナタタカイノ シ
燒	ヤクノ キュージノ ショー
燉	ヒヘンノ トン
燔	ヤクノ ハン
燎	リョーゲンノヒノ リョー
燠	アタタカイノ イク
燬	ヤクノ キ
燧	ヒヘンニ トゲルノ ヒウチ
燵	コタツノ タツ
燼	モエガラノ ジン
燹	ヘイセンノ セン
燿	カガヤクノ ヨー
爍	カガヤクノ シャク
爐	イロリノ キュージノ ロ
爛	ケンランゴーカノ ラン
爨	ハンゴースイサンノ サン
爭	アラソーノ キュージノ アラソウ
爬	ハチュールイノ ハ
爰	オン ココニノ エン
爲	コーイノ キュージタイノ イ
爻	マジワルノ コー
爼	マナイタノ ソ
爿	ショーヘンノ ショー
牀	サカンノ キュージノ ソー
牆	カキネノ ショー
牋	フダノ セン
牘	フダノ トク
牴	アタルノ テイ
牾	ウシヘンニ ワレノ ゴ
犂	スキノ レイ
犁	レイノイジノ レイ
犇	ヒシメノ ヒシ
犒	ネギラウノ コー
犖	マダラーシノ ラク
犢	コウシ ウシヘンニ ウルノ キュージノ トク
犧	イケニエノ キュージノ ギ
犹	ケモノヘンニ ユーノ ユー
犲	ヤマイヌノ サイ
狃	ナレルノ ジュー
狆	イヌノチンノ チュー
狄	エビスノ テキ
狎	ナレルノ コー
狒	サルヒノ ヒ
狢	ケモノヘンニ オノオノノ ムジナ
狠	ハナハダシイノ コン
狡	コーカツノ コー
狹	セマイノ キュージノ キョー
狷	ケンカイノ ケン
倏	スミヤカノ シュク
猗	ケモノヘンニ キ スナオノ イ
猊	ゲイカノ ゲイ
猜	サイギシンノ サイ
猖	ショーケツノ ショー
猝	ニワカノ ソツ
猴	モッコーニシテカンスノ コー
猯	イノシシノ タン
猩	ショーコーネツノ ショー
猥	ワイセツノ ワイ
猾	コーカツノ カツ
獎	ススメルノ キュージノ ショー
獏	バクノイジノ バク
默	ダマルノ キュージノ モク
獗	タケルノ ケツ
獪	ローカイノ カイ
獨	ドクイサイノ ドク
獰	ドーモーナノ ドー
獸	ケモノノ キュージノ ジュー
獵	カルノ キュージノ リョー
獻	ササゲルノ キュージノ ケン
獺	カワウソノ ウソ
珈	オーヘンニ クワエルノ カ
玳	タイマイノ タイ
珎	ワドーカイホーノ ホー
玻	ガラスノ ハ
珀	コハクノ ハク
珥	オーヘンニ ミミノ ジ
珮	オーヘンニ ハイノ ハイ
珞	ヨーラクキョーノ ラク
璢	ルノ キュージノ ル
琅	ローカンノ ロー
瑯	ローノ キュージノ ロー
琥	コハクノ コ
珸	オーヘンニ ワレノ ゴ
琲	オーヘンニ アラズノ ハイ
琺	オーヘンニ ホーノ ホー
瑕	キズノ カ
琿	アイグンジョーヤクノ グン
瑟	キンシツアイワスノ シツ
瑙	メノーノ ノー
瑁	オーヘンニ オカスノ ボー
瑜	サンミツユガノ ユ
瑩	カガヤクノ エイ
瑰	オーヘンニ オニノ カイ
瑣	ホクボーサゲンノ サ
瑪	メノーノ メ
瑶	タマノイジノ ヨー
瑾	オーヘンニ キンノ キン
璋	オーヘンニ ショーノ ショー
璞	アラタマノ ハク
璧	カンペキノ ヘキ
瓊	イナゴノ ケイ
瓏	ハチメンレイローノ ロー
瓔	ヨーラクキョーノ ヨー
珱	クビカザリノ エイ
瓠	ヒサゴノ コ
瓣	ベンノ キュージノ ベン
瓧	オモサノタンイノ デカグラム
瓩	オモサノタンイノ キログラム
瓮	モタイノ オー
瓲	オモサノタンイノ トン
瓰	オモサノタンイノ デシグラム
瓱	オモサノタンイノ ミリグラム
瓸	オモサノタンイノ ヘクトグラム
瓷	ヤキモノノ シ
甄	ツエモノノ ケン
甃	シキガワラノ シュー
甅	オモサノタンイノ センチグラム
甌	キンオームケツノ オー
甎	カワラノ セン
甍	イラカノ ボー
甕	カメノ オー
甓	シキガワラノ ヘキ
甞	ナメルノイジノ ショー
甦	ソセイジュツノ ソ
甬	ワクノ ヨー
甼	マチノイジノ チョー
畄	トドメルノ リャクジノ リュー
畍	タヘンニ カイノ カイ
畊	タガヤスノ コー
畉	タヘンニ オットノ フ
畛	シンイキノ イン
畆	ウネンジノ ホ
畚	モッコノ ホン
畩	タヘンニ コロモノ ケサ
畤	タヘンニ テラノ ジ
畧	アラマシノイジノ リャク
畫	エガクノ キュージノ ガ
畭	タヘンニ アマリノ ヨ
畸	キケイジノ キ
當	キュージノトーセンノ トー
疆	サカイノ キュージノ キョー
疇	ハンチューニハイルノ チュー
畴	チューノ リャクジノ チュー
疊	タタミノ キュージノ ジョー
疉	タタミノホンジノ ジョー
疂	タタミノ ジョー
疔	ヤマイダレニチョーノ チョー
疚	ヤマイノ キュー
疝	ハライタノ セン
疥	ガンセンノ ガン
疣	ヤマイダレニノ イボ
痂	ケッカノ カ
疳	カンノムシノ カン
痃	オーゲンノ ゲン
疵	キズツクノ キズ
疽	エソノ ソ
疸	ビョーキ オーダンノ ダン
疼	ウズクノ トー
疱	スイホーノ ホー
痍	イマダイエズノ イ
痊	ケッセンノ セン
痒	カユイ イミノ ヨー
痙	ケイレンノ ケイ
痣	アザノ シ
痞	ヤマイダレノ ヒ
痾	ヤマイノ ア
痿	ナエルノ イ
痼	ナガワズライノ シコリ
瘁	ツカレルノ スイ
痰	カクタンノ タン
痺	マヒスルノ ヒ
痲	アサノノ マ
痳	リンビョーノ リン
瘋	キチガイノ フー
瘍	アクセイシュヨーノ ヨー
瘉	ナオルノ ユ
瘟	オンエキノ オン
瘧	ギャクビョーノ ギャク
瘠	ヤセルノ ソー
瘡	カサブタノ カサ
瘢	ハンコンノ ハン
瘤	コブノ リュー
瘴	ショーキノ ショー
瘰	ルイレキノ ルイ
瘻	ズイエキローノ ロー
癇	カンシャクダマノ カン
癈	ハイジンノ ハイ
癆	ジンローノ ロー
癜	コクショクデンプーノ デン
癘	レイキノ レイ
癡	オロカノ キュージノ チ
癢	カユイノイジノ ヨー
癨	カクランノ カク
癩	ライビョーノ ライ
癪	カンシャクダマノ シャク
癧	ルイレキノ レキ
癬	オーセンノ セン
癰	ヨーソノ ヨー
癲	テンカンノ テン
癶	ハツガシラノ ハツ
癸	ミズノトノ キ
發	ハナツノ キュージノ ハツ
皀	カンバシイノ キュー
皃	カタドルノイジノ ボー
皈	カエルノイジノ キ
皋	サツキノイジノ コー
皎	シロヘンニ コーノ コー
皖	シロヘンニ カンノ カン
皓	シロイニツゲルノ コー
皙	ハクセキノ セキ
皚	ガイゼンノ ガイ
皰	ニキビノ ホー
皴	ヒビノ シュン
皸	アカギレノ クン
皹	テノアカギレノ アカギレ
皺	イスーヘキノ スー
盂	ジンウジンエンノ ウ
盍	ガンキューシントーノ トー
盖	ケダシノイジノ ガイ
盒	ハンゴースイサンノ ゴー
盞	キンセンカノ セン
盡	ツキルノ キュージノ ジン
盥	タライマワシノ タライ
盧	ロセイノ ロ
盪	ノーシントーノ トー
蘯	トーノイジノ トー
盻	メヘンニ ケイノ ケイ
眈	コシタンタンノ タン
眇	スガメノ ビョー
眄	ウコサベンノ ベン
眩	メマイノ ゲン
眤	メヘンニ アマノ イ
眞	キュージ マコトノ シン
眥	セイノ マナジリ
眦	メヘンニ コレノ マナジリ
眛	クライノ マイ
眷	カエリミルノ ケン
眸	メイボーノ ボー
睇	メヘンニ オトートノ テイ
睚	ニラムノ ガイ
睨	ヘイゲイノ ゲイ
睫	マツゲノ ショー
睛	ガリョーテンセイノ セイ
睥	ヘイゲイノ ヘイ
睿	サトイノ キュージタイノ エイ
睾	コーガンノ コー
睹	ミルノ ト
瞎	メヘンニ ソンガイノ ガイ、 カタメ
瞋	イカルノ シン
瞑	メイモクスルノ メイ
瞠	ミツメルノ ドー
瞞	ギマンノ マン
瞰	メヘンニ カントーショーノ カン、 ミル
瞶	メヘンニ トートイノ キ
瞹	メヘンニ アイノ アイ
瞿	クゼンノ ク
瞼	マブタノ ケン
瞽	メシイノ コ
瞻	センボーノ セン
矇	モーマイノ モー
矍	カクシャクトスルノ カク
矗	チョクシュツノ チョク
矚	ショクモクノ ショク
矜	ツツシムノ キン
矣	ムニヤノ イ
矮	コビト ワイショーノ ワイ
矼	イシヘンニ コーノ コー
砌	セイノ ミギリ
砒	ヒソノ ヒ
礦	アラガネノ コー
砠	イシヤマノ ショ
礪	トナミシノ ト
硅	タンソノ ケイ
碎	キュージノ サイ
硴	イシヘンニ ハナノ カキ
碆	ナミニイシノ ハ
硼	ホーサンノ ホー
碚	ハイライノ ハイ
碌	アオイノ ロク
碣	イシブミノ ケツ
碵	イシヘンニ テイノ セキ
碪	キヌタノイジノ チン
碯	イシヘンニ ノーノ ノー
磑	イシヘンニ ガイノ ガイ
磆	イシヘンニ ホネノ カツ
磋	ミガク セッサタクマノ サ
磔	ハリツケノ タク
碾	イシヘンニ テンノ テン
碼	タンイノヤードノ メ
磅	タンイノポンドノ ホー
磊	ライラクノ ライ
磬	ケイセツノ ケイ
磧	イシヘンニ セキノ セキ
磚	カワラノ セン
磽	コーカクノ コー
磴	イシヘンニ ノボルノ トー
礇	タマシイノ イク
礒	イソノ ギ
礑	イシヘンニ アタルノ トー
礙	イシヘンニ ウタガウノ ガイ
礬	ミョーバンノ バン
礫	ガレキノヤマノ レキ
祀	マツル サイシノ シ
祠	ホコラノ シ
祗	ツツシムノ シ
祟	タタリノ タタ
祚	サイワイノ ソ
祕	ヒメルノ ヒ
祓	ハライキヨメルノ ハラ
祺	シメスヘンニ ソノノ キ
祿	ロクノ キュージノ ロク
禊	ミソギノ ミソ
禝	シメスヘンノ ショク
禧	シメスヘンニ ヨロコブノ キ
齋	キュージ ショサイノ サイ
禪	ゼンノ キュージノ ゼン
禮	キュージ レイセツノ レイ
禳	ハラウノ ジョー
禹	ウオウノ ウ
禺	オナガザルノ グ
秉	イナホヲ テニ モツ サマノ ヘイ
秕	シイナノ ヒ
秧	ナエノ オー
秬	クロキビノキビノ キョ
秡	イタムノ ハツ
秣	マグサノ マツ
稈	バッカンサナダノ カン
稍	ノギヘンノ ショー
稘	ノギヘンニ ソノノ キ
稙	ハヤマキノノ ショク
稠	カネンチョーノ チョー
稟	リンギヲ オコスノ リン
禀	リンノイジノ リン
稱	タタエルノ キュージノ ショー
稻	イネノイジノ トー
稾	ワラノ コー
稷	キビノ ショク
穃	ノギヘンニ ヨーノ ヨー
穗	ホノイジノ スイ
穉	オサナイノイジノ チ
穡	ショクフノ ショク
穢	ケガレノ アイ
穩	オダヤカノ キュージノ オン
龝	アキノ キュージノ シュー
穰	ミノルノ キュージノ ジョー
穹	キューテンノ キュー
穽	カンセイノ セイ
窈	ヨーチヨーノ ヨー
窗	マドノ キュージノ ソー
窕	ヨーチョーノ チョー
窘	タシナメルノ タシナ
窖	アナグラノ コー
窩	クボミノ カ
竈	アナカンムリノノ カマド
窰	カマノ キュージノ ヨー
窶	ヤツレルノ ク
竅	アナノ キョー
竄	カイザンノ ザン
窿	アナニリューノ リュー
邃	ユースイノ スイ
竇	アナカンムリニ ウルノ キュージノ トク
竊	ヌスムノ キュージノ セツ
竍	タイセキノタンイノ デカリットル
竏	タイセキノタンイノ キロリットル
竕	タイセキノタンイノ デシリットル
竓	タイセキノタンイノ ミリリットル
站	タツノ タン
竚	タタズムノ チョ
竝	ナラブノ キュージノ ヘイ
竡	タイセキノタンイノ ヘクトリットル
竢	マツノ シ
竦	イイスクメルノ スク
竭	ツクスノ ケツ
竰	タイセキノタンイノ センチリットル
笂	タケニ マルノ ウツボ
笏	シコツコノ コツ
笊	タケカンムリニ テアシノ ツメノ ザル
笆	タケニ トモエノ ハ
笳	フエノイッシュノ カ
笘	タケニ シメルノ セン
笙	タケカンムリニ ウマレルノ ショー
笞	ムチノ チ
笵	タケニ ハンノ ハン
笨	タケニ ホンノ ホン
笶	タケカンムリニ ヤノ シ
筐	ショータイノ ショー
筺	テンノアルキョーノ キョー
笄	カンザシノ ケイ
筍	タケカンムリノ タケノコ
笋	コトノ ソー
筌	オチャノ セン
筅	オチャノ セン
筵	タケカンムリノ エン
筥	ハコノ キョ
筴	タケニ キョーノ キョー
筧	カケヒノ ケン
筰	タケニ ツクルノ サク
筱	シノノイジノ ショー
筬	タケニ ナルノ セイ
筮	ウラナウ ゼイチクノ ゼイ
箝	カンコーノ カン
箘	タケニ キンノ キン
箟	タケニ コンノ コン
箍	オケノ タガ
箜	タケニ ソラノ ク
箚	サスノ トー
箋	テガミノ セン
箒	チリヲ トル ホーキノ ホーキ
箏	コトノ ソー
筝	ソーノ ゾクジノ ソー
箙	エビラノ フク
篋	ハコ キョータイノ キョー
篁	ジンメイノ タカムラ
篌	タケニ コーノ コー
篏	ハメコムノ カン
箴	イマシメ シンカンノ シン
篆	チョーチューテンコクノ テン
篝	カガリビノ カガリ
篩	フルイ タケカンムリニ ヒョーシノ シ
簑	タケカンムリニ オトロエルノ ミノ
簔	タケカンムリニ オトロエルノ キュージノ ミノ
篦	カンザシノ ヘイ
篥	タケニ クリノ リツ
籠	カゴノ トリノ カゴ
簀	サカナノ イケスノ ス
簇	シューゾクノ ゾク
簓	タケニ ホルノ ササラ
篳	イバラノ ヒツ
篷	トマノ ホー
簗	ヤナノ リョー
簍	タケカゴノ ル
篶	タケニ エンノ エン
簣	モッコノ キ
簧	ガッキノ リードノ コー
簪	カンザシノ カン
簟	ムシロノ テン
簷	ノキノ エン
簫	フエノノ ショー
簽	センオーノ セン
籌	ハカリゴトノ チュー
籃	ヨーランノ ラン
籔	ヤブノ キュージノ ソー
籏	タケニ ハタノ キ
籀	タケニ リューノ チュー
籐	ツルノ トー
籘	ツルノ イジノ トー
籟	タケニ ライノ ライ
籤	セン クジノチューセンノ ヒコ
籖	オミクジノ セイジノ セン
籥	ガッキノ ヤク
籬	マガキノ リ
籵	ナガサノ タンイノ デカメエトル
粃	シイナノ ヒ
粐	コメヘンニ トノ ト
粤	オチノ エツ
粭	コメヘンニ ゴーノ スクモ
粢	キビノ シ
粫	コメニ シカシテノ ジ
粡	チマキノ トー
粨	ナガサノ タンイノ ヘクトメートル
粳	オコメノ ウルチ
粲	カガヤクノ サン
粱	アワノ リョー
粮	ヒョーローノ ロー
粹	イキノ イジノ スイ
粽	チマキノ ソー
糀	コメコージノ コー
糅	ナジルノ ジュー
糂	コメヘンニ ジンノ サン
糘	コメヘンニ イエノ スクモ
糒	ホシイノ ビ
糜	ニュービソーノ ビ
糢	コメヘンニ モノ モ
鬻	ヒサグノ シュク
糯	モチゴメノ ダ
糲	アラヅキゴメノ レイ
糴	カイヨネノ テキ
糶	ウリヨネノ チョー
糺	キューダンスルノ キュー
紆	ウヨキョクセツノ ウ
紂	チューオーノ チュー
紜	イトヘンニ イウ ミダレノ ミダ
紕	イトヘンニ コレノ ヒ
紊	フーキビンランノ ビン
絅	ヒキシメルノ ケイ
絋	ハッコーノ コー
紮	ケッサツノ サツ
紲	キズナノ セツ
紿	イトヘンニ ダイノ タイ
紵	アサヌノノ チョ
絆	バンソーコーノ ハン
絳	アカイロノ コー
絖	イトヘンニ ヒカリノ コー
絎	イトヘンニ イクノ コー
絲	イトノ キュージノ シ
絨	ジュータンノ ジュー
絮	ワタノ ジョ
絏	セツノ ゾクジノ セツ
絣	カスリノ キモノノ カスリ
經	ヘルノ キュージノ ケイ
綉	シシューノ ゾクジノ シュー
絛	サナダノ ジョー
綏	ヤスラカノ スイ
絽	ナツニ キルノ ロ
綛	イトヘンニ シノブノ カスリ
綺	キソーキョクノ キ
綮	コーケイニ アタルノ ケイ
綣	イトヘンニ マクノ ケン
綵	アヤノ サイ
緇	クロギヌノ シ
綽	ヨユーシャクシャクノ シャク
綫	センノ キュージノ セン
總	ソーイチローノ ソー
綢	ドンスノ チュー
綯	ナイマゼノ ナ
緜	ワタノホンジノ ベン
綸	リンズノ リン
綟	イトヘンニ モドルノ レイ
綰	ツナグノ ワン
緘	トジルノ カン
緝	トラエルノ シュー
緤	キズナノ セツ
緞	キンランドンスノ ドン
緻	チミツノ チ
緲	ハルカノ ビョー
緡	イトヘンノ ビン
縅	イトヘンニ イノ オドシ
縊	イトヘンニ リエキノ エキノ イ
縣	ケンニノノイトノ ケン
縡	コトキレルノ サイ
縒	ヨリイトノ シ
縱	タテノ キュージノ ジュー
縟	ハンブンジョクレイノ ジョク
縉	アカイキヌノ シン
縋	スガルノ スガ
縢	ムカバキノ トー
繆	アヤマリノ ビュー
繦	ヒトヘンニ ツヨイノ キョー
縻	ツナグノ ビ
縵	ムジノキヌノ マン
縹	イトヘン ヒョービョーノ ヒョー
繃	イトニクズレルノ ホー
縷	ルゲンノ ル
縲	ツナグノ ルイ
縺	モツレルノ レン
繧	イトヘンニ クモノ ウン
繝	ニシキノアヤノ カン
繖	イトヘンニ チルノ サン
繞	メグルノ ジョー
繙	ヒモトクノ ハン
繚	ヒャッカリョーランノ リョー
繹	タズネル エンエキノ エキ
繪	キュージノ カイ
繩	ナワノ キュージノ ジョー
繼	ツグノ キュージノ ケイ
繻	ウスギヌノ シュ
纃	カスリノホンジノ カスリ
緕	カスリノイジノ カスリ
繽	ヒンブンノ ヒン
辮	ベンパツノ ベン
繿	ボロノ ラン
纈	コーケツノ ケツ
纉	ツグノ サン
續	ツヅクノ キュージノ ゾク
纒	マトイツクノ マト
纐	コーケツノ コー
纓	ムナガイノ エイ
纔	ワズカニノ サイ
纖	センノ セイジノ セン
纎	センノ キュージノ セン
纛	ハタノ トー
纜	トモヅナノ ラン
缸	カメノ コー
缺	カケルノ キュージノ ケツ
罅	テノヒビノ ヒビ
罌	オーノ ケ
罍	サカダルノ ライ
罎	ビンノイジノ ドン
罐	フルイノ カン
网	アミガシラノ ボー
罕	マレニノ カン
罔	アミノ モー
罘	ヨンガシラニフノ フ
罟	アミノ コ
罠	ワナヲ シカケルノ ワナ
罨	オンアンポーノ アン
罩	カゴノ トー
罧	ヨンニハヤシノ リン
罸	ツミノ ゾクジノ バツ
羂	ヨンニキヌノ ケン
羆	ドーブツノ ヒグマ
羃	ベキジョーノ ベキ
羈	タズナノ セイジノ キ
羇	キリョノ キ
羌	エビスノ キョー
羔	コヒツジ ヒツジカンムリニ レッカノ コー
羞	シューチシンノ シュー
羝	オヒツジノ テイ
羚	カモシカノ レイ
羣	ムレノイジノ グン
羯	キョセイシタヒツジノ カツ
羲	オーギシノ ギ
羹	ヨーカンノ カン
羮	コーノイジノ コー
羶	ナマグサイノ セン
羸	ヤセルノ ルイ
譱	ヨイノ キュージノ ゼン
翅	ソーシモクノ シ
翆	ホーセキノ スイ
翊	タスケルノ ヨク
翕	アツマルノ キュー
翔	アマカケルノ カケ
翡	ホーセキノ ヒ
翦	キルノ セイジノ セン
翩	ヒルガエルノ ヘン
翳	シロソコヒノ ヒ
翹	アゲルノ ギョー
飜	ホンテンノ ホン
耆	ホーキノクニノ キ
耄	オイボレノ ボレ
耋	トシヨリノ テツ
耒	スキノ ライ
耘	トリノ ゾクノ ウン
耙	スキヘンニ トモエノ ハ
耜	スキノ シ
耡	スキノ ジョ
耨	スキノ ジョク
耿	アキラカノ コー
耻	ハジルノイジノ チ
聊	ミミヘンニ エトノ ウノ イササカ
聆	キクノ レイ
聒	カマビスシイノ カツ
聘	マネクノ ヘイ
聚	アツマルノ ジュ
聟	チシキノ チノ シタニ ミミノ ムコ
聢	ミミヘンノ テイ
聨	ダイニ ドイツレンポーノ レン
聳	ソビエルノ ソビ
聲	フルイノ セイ
聰	ジンメイ サトルノ ソー
聶	ササヤクノ ジョー
聹	ミミアカノ デイ
聽	キクノ キュージノ チョー
聿	イチノ イツ
肄	ナラウノ イ
肆	ミセノ シ
肅	ツツシムノ キュージノ シュク
肛	コーモンノ コー
肓	ボーノシタニニクヅキノ コー
肚	ハラノ ト
肭	ツキヘンニ ーチノ トツ
冐	オカスノイジノ ボー
肬	イボノ キュージノ イボ
胛	ケンコーコツノ コー
胥	ショリノ ショ
胙	ヒモロギノ サク
胝	タコノ チ
胄	カッチューノ チュー
胚	ガイハイヨーノ ハイ
胖	ヒハンノ ハン
脉	ニクヅキ ミャクシンノ ミャク
胯	マタノ コ
胱	ヒニョーキボーコーノ コー
脛	ケイコツノ ケイ
脩	ニクヅキノ シュー
脣	クチビルノ イジノ シン
脯	ホグシノ ホ
腋	ニクヅキニ ヨルノ ワキノシタ
隋	コダイチューゴクノ ズイ
腆	アツイノ テン
脾	ゾーキノヒゾーノ ヒ
腓	ヒコツノ ヒ
腑	ゴゾーロップノ フ
胼	タコノ ヘン
腱	スジノ ケン
腮	エラノ サイ
腥	ニクヅキニ ホシノ ナマグサ
腦	ノーノ キュージノ ノー
腴	コエルノ ユ
膃	オットセイノ オツ
膈	ニクヅキニ ブシュノ カク オーカクマクノ カク
膊	ジョーハクノ ハク
膀	ヒニョーキボーコーノ ボー
膂	セボネ タビノ シタニニクヅキノ リョー
膠	コーゲンビョーノ コー
膕	カクノ ヒカガミ
膤	ニクヅキニ ユキノ セツ
膣	ニクヅキニ チッソノチツ ジョセイノ チツ
腟	ニクヅキニ ウカンムリ ジョセイノ チツ
膓	ハラワタノイジノ チョー
膩	アダラギルノ ジ
膰	ヒモロギノ ハン
膵	ゾーキ スイゾーノ スイ
膾	ナマスノ カイ
膸	ツメノ イジノ ズイ
膽	キモノイジノ タン
臀	シリノ イミノ デン
臂	カベノ ツチノ カワリニ ニクヅキノ ウデ
膺	ムネヲ イミスル ニクヅキノ ヨー
臉	カオノ ケン
臍	ヘソノ サイ
臑	ニクヅキニ アメノ シタニ チカシテノ スネ
臙	ノドノ エン
臘	ローゲツノ ロー
臈	ロータケタノ ロー
臚	ニクヅキニ リョノ リョ
臟	ハラワタノ キュージノ ゾー
臠	コマギレノ レン
臧	ヨイノ ゾー
臺	キュージ タイフーノ タイ
臻	イタルノ シン
臾	ヒキトメルノ ユ
舁	カゴヲ カクノ カ
舂	ウスヅクノ ショー
舅	ヨメシュートノ シュート
與	ダイニ アタエルノ ヨ
舊	フルイジノ キュー
舍	ヤドルノ キュージノ シャ
舐	ナメルノ シ
舖	ミセノ キュージノ ホ
舩	フネヘンニ オオヤケノ フナ
舫	フネヘンニ ホーノ ホー
舸	フネヘンニ カノ カ
舳	フネノ ヘサキノ ヘ
艀	ハシケノ フ
艙	フネヘンニ ソーゴノ ソー
艘	フネノ カズノ ソー
艝	フネヘンニ ユキノ ソリ
艚	フネヘンニ ソーノ ソー
艟	フネヘンノ ドーノ トー
艤	フネノ ソービノ ギ
艢	フネヘンニ ショーノ ショー
艨	モーショーノ モー
艪	フネヘンニ ロノ ロ
艫	トモヅナノ トモノ ロ
舮	トモノ リャクジノ ロ
艱	カンナンシンクノ カン
艷	エンノ キュージノ エン
艸	クサノ ソー
艾	ヨモギノ ガイ
芍	シャクヤクノ シャク
芒	ススキヲ アラワス イミノ ボー
芫	クサニ ゲンノ カン
芟	タルノ サン
芻	マグサ ハンスースルノ スー
芬	ゾクシュー フンプンノ フン
苡	オーバコノ イ
苣	クサカンムリノ キョ
苟	イヤシクモノ イヤシク
苒	ゼンジャクノ ゼン
苴	アサノ ショ
苳	クサカンムリニ フユノ トー
苺	クサカンムリニ ハハノ イチゴ
莓	ダイニスイジュンノ イチゴ
范	ジンメイ ハンショノ ハン
苻	クサカンムリニ フノ フ
苹	ウキクサノ ヘイ
苞	ツツミノ ホー
茆	ジュンサイノ ボー
苜	クサカンムリニ メノ モク
茉	クサカンムリニ スエノ バツ
苙	クサニタツノ リュー
茵	インチンコートーノ イン
茴	ウイノ カイ
茖	ヤマニラノ カク
茲	クサカンムリノノ ココ
茱	グミノ シュ
荀	ジュンシノ ジュン
茹	ウダルアツサノ ウダ
荐	シキリニノ セン
荅	クサニゴーノ トー
茯	クサニフセルノ フク
茫	ボーゼンジシツノ ボー
茗	クサカンムリ ミョーガノ ミョー
茘	オオニラノ レイ
莅	クサニクライノ リ
莚	エン ハビコルノ ムシロ
莪	ツノヨモギノ ガ
莟	ツボミノ ガン
莢	サヤマメノ サヤ
莖	クキノ キュージノ ケイ
茣	ゴザノ ゴ
莎	クサカンムリニ サノ サ
莇	クコノ チョ
莊	ヤシキノ キュージノ ソー
荼	ダビニフスノ ダ
莵	ウサギノイジノ ト
荳	マメノ トー
荵	シノブグサノ ジン
莠	ネコジャラシノ ユー
莉	クサカンムリニ リエキノ リ
莨	タバコノ ロー
菴	イオリノ キュージノ アン
萓	ワスレナグサノ ギ
菫	クサバナノ スミレ
菎	カオリグサノ コン
菽	シュクバクノ シュク
萃	アツマルノ スイ
菘	スズナノ スー
萋	クサニツマノ セイ
菁	カブノ セイ
菷	ホーキノ シュー
萇	クサニナガイノ チョー
菠	ホーレンソーノ ホー
菲	ウス ヒハクノ ヒ
萍	ウキクサノ ヘイ
萢	クサニアワノ ヤチ
萠	メバエノ ホー
莽	クラムラノ モー
萸	ヤクソーノナノ ユ
蔆	ヒシノ リョー
菻	クサニハヤシノ リン
葭	ヨシノ カ
萪	クサカンムリニ カノ カ
萼	ハナノーテナノ ガク
蕚	フルイノ ガク
蒄	ニクズクカンノ ク
葷	クンシュノ クン
葫	ニンニクノクンノ コ
蒭	ホシグサノ スー
葮	ムクゲノ タン
蒂	シテイノ テイ
葩	カベンノ ハ
葆	カクスノ ホー
萬	キュージノ マン
葯	オシベノセンタンノ ヤク
葹	クサニホドコスノ シ
萵	チサノ ワ
蓊	クサニオキナノ オー
葢	ツタノイジノ ガイ
蒹	クサニカネルノ ケン
蒿	インチンコートーノ コー
蒟	コンニャクノ コン
蓙	ゴザノ ザ
蓍	メトギノ シ
蒻	コンニャクノ ニャク
蓚	シューサンエンニョーノ シュー
蓐	シトネノ ジョク
蓁	クサムラノ シン
蓆	ムシロノ セキ
蓖	ヒマシユノ ヒ
蒡	ゴボーヌキノ ボー
蔡	クサニマツリノ サイ
蓿	クサニヤドルノ シュク
蓴	ヌナワノシュンノ ジュン
蔗	サトー ショトーノ ショ
蔘	ニンジンノジンノ サン
蔬	アオモノノ ソ
蔟	アツマルノ ソー
蔕	カジツノジクノ ヘタ
蔔	ホフクゼンシンノ フク
蓼	ショクブツノタデノ タテ
蕀	クサニキョクノ キョク
蕣	ムクゲノ シュン
蕘	タキギノ ジョー
蕈	キノコノ シン
蕁	ジンマシンノ ジン
蘂	シベノ ズイ
蕋	ズイノ ゾクジノ ズイ
蕕	ハリガネソーノ ユー
薀	ツムノ ウン
薤	ラッキョーノ カイ
薈	シゲルノ ワイ
薑	カジカミノ キョー
薊	ショクブツノ アザミ
薨	コーキョノ コー
蕭	カゼガショーショートフクノ ショー
薔	クサカンムリノノ ショー
薛	ヨモギノ セツ
藪	ヤブノ キュージノ ソー
薇	クサカンムリニ カスカノ ゼンマイ
薜	ヘイリノ ヘイ
蕷	クサニアズケルノ ヨ
蕾	ゼツ ミライノ ライ
薐	ホーレンソーノ レン
藉	ローゼキノ ゼキ
薺	ナナクサノ ナズナ
藏	クラノ キュージノ ゾー
薹	クサカンムリノノ タイ
藐	サンミャクインリューノ ミャク
藕	ハスノネノ グー
藝	ゲイノ キュージノ ゲイ
藥	クスリノ キュージノ ヤク
藜	アカギレノ レイ
藹	ワキアイアイノ アイ
蘊	ウンチクヲ カタムケルノ ウン
蘓	ヨミガエルノイジノ ソ
蘋	カタバミノ ヒン
藾	カワラヨモギノ ライ
藺	クサカンムリニ モンガマエニ フルトリノ イグサ
蘆	アシ ロカノ ロ
蘢	オオケダテノ ロー
蘚	コケノ セン
蘰	クサノ カツラ
蘿	カズラノ ラ
虍	トラガシラノ コ
乕	イタイジ トラノ コ
虔	ケイケンナキモチノ ケン
號	サケブノ キュージノ ゴー
虧	タケルノ キ
虱	ゾクジノ シラミ
蚓	ムシヘンニ インリョクノ インノ ミミズ
蚣	ムカデノ コー
蚩	ワラウノ シ
蚪	ムシヘンニ トーノ トー
蚋	ブヨノ ゼイ
蚌	ドブガイノ ホー
蚶	ムシヘンニ アマイノ カン
蚯	ミミズノ キュー
蛄	オケラノ ケラ
蛆	ウジムシノ ウジ
蚰	ムシヘンニ ユノ ユー
蛉	トンボノ ボ
蠣	ムシヘンニ ガンダレニ マンノ カキ
蚫	ムシヘンニ ツツムノ ホー
蛔	キセイチュー カイチューノ カイ
蛞	ナメクジノ カツ
蛩	コオロギノ キョー
蛬	キョーオンノ キョー
蛟	ミズチノ コー
蛛	クモノ モ
蛯	ムシヘンニ オイルノ エビ
蜒	ムシヘンニ ノビルノ エン
蜆	シジミガイノ シジミ
蜈	ゴコーノ ゴ
蜀	トーモロコシノ モロ
蜃	シンキローノ シン
蛻	ヌケガラノ ゼイ
蜑	タンジンノ タン
蜉	カゲローノカゲノ フ
蜍	ムシヘンニ アマリノ ヨ
蛹	サナギノ ヨー
蜊	アサリガイノ リ
蜴	トカゲノ カゲ
蜿	ムシヘンニ アテノ エン
蜷	トグロヲ マクノ ト
蜻	トンボノ トン
蜥	トカゲノ ト
蜩	セミノ ヒグラシ
蜚	ゴキブリノ ゴキ
蝠	コーモリガサノ モリ
蝟	ムシヘンニ イブクロノ イノ ハリネズミ
蝸	カタツムリノ カ
蝌	オタマジャクシノ カ
蝎	サソリノ カツ
蝴	コチョーノユメノ コ
蝗	ムシヘンニ コーカイシノ コーノ イナゴ
蝨	シラミノイジノ シツ
蝮	ムシヘンノ マムシ
蝙	コーモリガサノ コー
蝓	ムシヘンニ ユノ ユ
蝣	カゲローノローノ ユー
蝪	クモノイッシュノ トー
蠅	ハエノ キュージノ ヨー
螢	ケイセツノ ケイ
螟	ズイムシノ メイ
螂	ムシヘンニ ローノ カマキリ
螯	ハサミノ ゴー
蟋	キリギリスノ シツ
螽	イナゴノ シュー
蟀	ムシヘンニ ソツノ シュツ
蟐	ムシヘンニ ツネノ ジョー
雖	イエドモノ イエド
螫	サスノ セキ
蟄	チッキョスルノ チツ
螳	カマキリノ カマ
蟇	ガマノアブラノ ガマ
蟆	バクノイジノ バク
螻	オケラノ オ
蟯	ギョーチューノ ギョー
蟲	ムシノ キュージノ チュー
蟠	ワダカマルノ ハン
蠏	カニノイジノ カイ
蠍	ムシヘンノノ サソリ
蟾	ヒキガエルノ セン
蟶	マテノ テイ
蟷	カマキリノ カマ
蠎	ウワバミノ ボー
蟒	ボーノイジノ ボー
蠑	ムシヘンニ サカエルノ エイ
蠖	シャッカクノ カク
蠕	チョーゼンドーノ ゼン
蠢	ウゴメクノ ウゴメ
蠡	ケイガシラノ レイ
蠱	コワクビノ コ
蠶	カイコノ キュージノ サン
蠹	トノ セイジ゙ノ ト
蠧	キクイノ ト
蠻	エビスノ キュージノ バン
衄	クジケルノ ジク
衂	ジンケツノ ジン
衒	テラウノ ゲン
衙	コクガノ ガ
衞	マモルノ キュージタイノ エイ
衢	チマタノ ク
衫	ジュバンノ サン
袁	エンコーノ エン
衾	ドーキンノ キン
袞	コンショクノ コン
衵	アコメノ ジツ
衽	エリノ ジン
袵	ジンノイジノ ジン
衲	ケサノ ノー
袂	キモノノ タモト
袗	ヒトエモノノ シン
袒	サタンノ タン
袮	コロモヘンニ ショーノ ネ
袙	コロモヘンニ シロノ ハ
袢	ジュバンノ バン
袍	ワタイレノ ホー
袤	ナガサノ ボー
袰	ハハニコロモノ ホロ
袿	ウチカケノ ケイ
袱	チャブダイノ ブ
裃	コロモニジョーゲノ カミシモ
裄	コロモニイクノ ユキ
裔	マツエイノ エイ
裘	カワゴロモキューノ キュー
裙	モスソノ クン
裝	ヨソオウノ キュージノ ソー
裹	ツツムノ カ
褂	コロモヘンノノ ウチカケ
裼	ハダヌグノ セキ
裴	ハイシゴリンノ ハイ
裨	タスケルノ ヒ
裲	ウチカケノ リョー
褄	コロモノ ツマ
褌	キンコンイチバンノ コン
褊	セマイノ ヘン
褓	オシメノ シメ
襃	ホメルノ キュージノ ホー
褞	ヌノコノ ウン
褥	サンジョクキノ ジョク
褪	タイ イロアセルノ ア
褫	ウバウノ チ
襁	オシメノ オ
襄	ソージョーノジンノ ジョー
褻	ワイセツノ セツ
褶	シューキョクノ シュー
褸	エリノ ル
襌	ヒトエノ タン
褝	タンノ リャクジノ タン
襠	コロモヘンノノ トー
襞	ヒダスカートノ ヒダ
襦	ジュバンノ ジュ
襤	ボロノ ラン
襭	ツマバサムノ ケツ
襪	タビノ ベツ
襯	ハダギノ シン
襴	コロモニランノ ラン
襷	タスキガケノ タスキ
襾	オオウノ ア
覃	フカクテヒロイノ タン
覈	シラベルノ カク
覊	タズナノ キ
覓	モトメルベキノ ベキ
覘	ウカガウノ テン
覡	オトコノミコノ ゲキ
覩	ミルノ ト
覦	コイネガウノ ユ
覬	ウカガウノ キ
覯	フトミルノ コー
覲	マミエルノ キン
覺	オボエルノ キュージノ カク
覽	ミルノ キュージノ ラン
覿	コーカテキメンノ テキ
觀	ミルノ キュージノ カン
觚	サカヅキノ コ
觜	クチバシノ シ
觝	ツノヘンノ テイ
觧	ツノヘンニ ヒツジノ カイ
觴	ランショーノ ショー
觸	サワルノ キュージノ ショク
訃	フホーノ フ
訖	オワルノキツノ キツト
訐	アバクノ ケツ
訌	ゴンベンニ タクミノ コー
訛	コトバノナマリノ ナマ
訝	イブカルノ イブカ
訥	ボクトツノ トツ
訶	マカマヤキョーノ カ
詁	ヨミノ コ
詛	ノローノ ソ
詒	ゴンベンニ ダイドコロノ ダイノ アザム
詆	ソシルノ テイ
詈	バリゾーゴンノ リ
詼	オドケルノ カイ
詭	キベンヲ ロースルノ キ
詬	ハズカシメルノ ゴ
詢	ハカルノ ジュン
誅	カレンチューキューノ チュー
誂	アツラエルノ アツラ
誄	ルイシノ ルイ
誨	オシエルノ カイ
誡	イマシメルノ カイ
誑	タブラカスノ キョー
誥	ツゲルノ コー
誦	アンショースルノ ショー
誚	セメルノ ショー
誣	ブコクザイノ ブ
諄	クドイノ ジュン
諍	イサカイノ イサカ
諂	ヘツラウノ ヘツラ
諚	シカトノ ジョー
諫	イサメルノイジノ カン
諳	ソランジルノ アン
諧	カイギャクノ カイ
諤	カンカンガクガクノ ガク
諱	イムノ キ
謔	カイギャクノ ギャク
諠	カマビスシイノ ケン
諢	オドケノ コン
諷	フーユノ フー
諞	ヘンゲンノ ヘン
諛	アユツイショーノ ユ
謌	ウタノ カ
謇	マコトノ ケン
謚	オクリナノ シ
諡	エキ オクリナノ オクリナ
謖	タツノ シュク
謐	セイヒツノ ヒツ
謗	ソシルノ ソシ
謠	ウタウノ ヨー
謳	オーカスルノ オー
鞫	キワメルノ キク
謦	ケイガイニセッスノ ケイガイ
謫	セメルノ タク
謾	アナドルノ マン
謨	ハカルノ ボ
譁	ウルサイノ カ
譌	ナマルノ カ
譏	キゲンガイイノ キ
譎	イツワリノ キツ
證	アカスノ キュージノ ショー
譖	センノイジノ セン
譛	ソシルノ セン
譚	カンタンノシンロンノ タン
譫	ウワゴトノ セン
譟	サワグノ ソー
譬	タトエルノ ヒ
譯	キュージ ホンヤクノ ヤク
譴	ケンセキノ ケン
譽	ホマレノ ホマ
讀	キュージノ トク
讌	サカモリノ エン
讎	カタキノ キュージノ シュー
讒	ソシルノ ザン
讓	ユズルノ キュージノ ジョー
讖	シルシノ シン
讙	ヨロコブノ カン
讚	タタエルノ キュージノ サン
谺	タニヘンニ キバノ コダマ
豁	カツゼンカイローノ カツ
谿	タニガワ ケイコクノ ケイ
豈	アニノ キ
豌	エンドーノ エン
豎	ニジュノ ジュ
豐	ユタカノ キュージノ ホー
豕	リョートーノイノコノ イノコ
豢	ヤシナウノ ケン
豬	イノシシノ キュージノ チョ
豸	ムジナノ チ
豺	ヤマイヌノ サイ
貂	ドーブツノ チョー
貉	ドーブツノムジナノ カク
貅	ムジナニヤスムノ キュー
貊	ケモノノナマエノ ハク
貍	タヌキノ キュージノ リ
貎	シカノコノ ゲイ
貔	ヒノ セイジノ ヒ
豼	モージューノナノ ヒ
貘	ドーブツノ バク
戝	タカラノ キュージノ ザイ
貭	タダスノ キュージノ シツ
貪	ドンショクサヨーノ ドン
貽	オクルノ イ
貲	タカラノ シ
貳	フタツノ キュージノ ニ
貮	フタツノイジノ ニ
貶	キヨホーヘンノ ヘン
賈	カギシンジョノ カ
賁	カザルノ ホン
賤	イヤシイノ セン
賣	ウルノ キュージノ バイ
賚	タマワルノ ライ
賽	サイセンバコノ サイ
賺	スカスノケンノ タン
賻	オクルノ フ
贄	イケニエノ ニエ
贅	ゼイタクノ ゼイ
贊	タスケルノ セイジノ サン
贇	ウツクシイサマノ イン
贏	モウケノ エイ
贍	ニギワスノ セン
贐	ハナムケノ ジン
齎	モタラスノ モタラ
贓	ゾーザイノ ゾー
賍	カイヘンニ ショーノ ソー
贔	ヒイキノ ヒ
贖	アガナウノ ショク
赧	シューノタンオーノ タン
赭	アカツチノ シャ
赱	ハシルノイジノ ソー
赳	タケダケシイノ キュー
趁	ハシルノ チン
趙	チョーセッコーノ チョー
跂	ツマダテルノ キ
趾	アト アシヘンニ トメルノ シ
趺	ケッカフザノ フ
跏	ケッカフザノ カ
跚	スイホマンザンノ ザン
跖	セキノイヌギョーニホユノ セキ
跌	ツマズクノ テツ
跛	アルキカタ ハコーノ ハ
跋	バッブンノ バツ
跪	ヒザマズクノ キ
跫	アシオトノ キョー
跟	カカトノ コン
跣	ハダシノ セン
跼	アシヘンニ ヤッキョクノ キョク
踈	ウトイノイジノ ソ
踉	ヨロメクノ ロー
跿	アシヘンニ ハシルノ ト
踝	アシヘンニ ケッカノ カノ クルブシ
踞	ソンキョスルノ キョ
踐	オコナウノ キュージノ セン
踟	アシヘンニ シルノ チ
蹂	ジンケンジューリンノ ジュー
踵	カカトノ キビス
踰	コエルノ ユ
踴	オドルノイジノ ヨー
蹊	ソケイブノ ケイ
蹇	アシナエヲ イミスル ケン
蹉	ツマヅクノ サ
蹌	ヨロメクノ ソー
蹐	アシヘンニ セキズイノ セキ
蹈	スギルノ イツ
蹙	ヒンシュクヲ カウノ シュク
蹤	アシヘンニ シタガウノ キュージ、 アト
蹠	アシヘンニ ショミンノ ショ、 オドル
踪	アシヘンニ シューキョーノ シュー、 アト
蹣	スイホマンザンノ マン
蹕	サキバライノ ヒツ
蹶	ツマヅクノ ケツ
蹲	ソンキョスルノ ソン
蹼	アシヘンノ ミズカキ
躁	ソーウツビョーノ ソー、 サワグ
躇	チューチョスルノ チョ
躅	アシブミノ チョク
躄	カベノ ツチノ カワリニ アシ、 アシナエ
躋	ノボルノ セイ
躊	チューチョスルノ チュー
躓	ツマヅクノ ツマヅ
躑	ソンキョスルノ ソン
躔	フムノ テン
躙	ジンケンジューリンノ リン
躪	リンノイジノ リン
躡	フムノ ジョー
躬	キッキューノ キュー
躰	カラダノノ テイ
軆	カラダノ キュージノ タイ
躱	ミヲ カワスノ カワ
躾	ブシツケノ シツケ
軅	ミヘンニ カリノ ヤガテ
軈	ミヘンニ オーノ ヤガテ
軋	キシム アツレキノ アツ
軛	クビキ クルマヘンニ ヤクノ アク
軣	トドロクノ リャクジノ ゴー
軼	クルマヘンニ サキノ テツ
軻	クルマヘンニ カノ カ
軫	クルマヘンニ ヒトヤネニ サンヅクリノ シン
軾	クルマヘンニ シキテンノ シキ シキミ
輊	クルマヘンニ イタルノ チ
輅	クルマヘンニ カクノ カク
輕	カルイノ キュージノ ケイ
輒	スナワチノ チョー
輙	クルマヘンニ ワキミノ ゾクジノ チョー
輓	クルマヘンニ メンキョノ メンノ バン
輜	クルマヘン ホログルマノ シ
輟	テツコーロクノ テツ
輛	リョーノ キュージノ リョー
輌	シャリョーノ リョー
輦	レンコクノモトノ レン
輳	クルマヘンニ カナデル フクソースルノ ソー
輻	フクシャネツノ フク
輹	クルマヘンニ オーフクノ フク
轅	ナガエノ エン
轂	コシキヲ イミスル コク
輾	クルマヘンニ テンランカイノ テン
轌	クルマヘンニ ユキノ ソリ
轉	コロガルノ キュージノ テン
轆	ロクロノ ロク
轎	カゴノ キョー
轗	フーンノ カン
轜	ヒツギグルマノ ジ
轢	キシム アツレキノ レキ
轣	クルマヘンニ レキノ レキ
轤	ロクロノ ロ
辜	ツミノ コ
辟	ヘキエキノ ヘキ
辣	アクラツノ ラツ
辭	ヤメルノ キュージノ ジ
辯	ベンノ キュージノ ベン
辷	セキツイスベリショーノ スベ
迚	シンニョーニナカノ トテモ
迥	ハルカノ ケイ
迢	ハルカノ チョー
迪	ミチビクノ テキ
迯	シンニョーニソトノ トー
邇	ニノ キュージノ ニ
迴	イ メグルノ カイ
逅	カイコーノ コー
迹	アトノ セキ
迺	スナワチノ ナイ
逑	シンニョーニモトムノ キュー
逕	コミチノイジノ ケイ
逡	チギシュンジュンノ シュン
逍	ツボウチショーヨーノ ショー
逞	タクマシイノ タクマ
逖	ハルカノ テキ
逋	ノガレルノ ホ
逧	シンニョーニタニノ ハザマ
逶	ナナメニイクノ イ
逵	ミチノ キ
逹	タッスルノ キュージノ タツ
迸	ホトバシルノ ホー
遏	トドメルノ アツ
遐	ハルカノ カ
遑	イトマノ コー
遒	シューノイジノ シュー
逎	ツヨイノ シュー
遉	サスガニノ テイ
逾	コエルノ ユ
遖	シンニョーニミナミノ アッパレ
遘	アウノ コー
遞	テイノ キュージノ テイ
遨	アソブノ ゴー
遯	ノガレルノ トン
遶	メグルノ ジョー
隨	キュージ シタガウノ ズイ
遲	オクレルノ キュージノ チ
邂	アウノ カイ
遽	キューキョケッテイシタノ キョ
邁	チョクオーマイシンノ マイ
邀	ヨーゲキノ ヨー
邊	ダイニ ニトーヘンサンカクケイノ ヘン
邉	アタリノイジノ ヘン
邏	ケイラノ ラ
邨	ソンラクノ ソン
邯	カンタンノアユミノ カン
邱	オカノ キョー
邵	セイノヒトツノ ショー
郢	ソノミヤコノ エイ
郤	スキマノ ゲキ
扈	トドメルノ コ
郛	クルワノ フ
鄂	インノクニノナノ ガク
鄒	モーシノセイチノ スー
鄙	ヒナビタノ ヒナ
鄲	カンタンノアユミノ タン
鄰	トナリノイジノ リン
酊	メイテイスルノ テイ
酖	タンデキノ タン
酘	トーシュノ トー
酣	ダイニスイジュンノ タケナワ
酥	タケヘンニ ノギノ ソ
酩	メイテイスルノ メイ
酳	ソソグノ イン
酲	フツカヨイノ テイ
醋	スノイジノ サク
醉	ヨーノ キュージノ スイ
醂	ミリンノ リン
醢	シオカラノ カイ
醫	イガクノ イ
醯	スノ ケイ
醪	ドブロクノ ロー
醵	キョキンノ キョ
醴	アマザケノ レイ
醺	ビクンノ クン
釀	カモスノ キュージノ ジョー
釁	ヒマノ キン
釉	ウワグスリノ ウワ
釋	ユルスノ キュージノ シャク
釐	オサメルヲ イミスルリノ リ
釖	カネヘンニ カナタノ トー
釟	カネヘンニ ハチノ ハツ
釡	カマノイジノ フ
釛	カネヘンニ チカラノ コク
釼	ツルギノイジノ ケン
釵	カンザシノ サ
釶	カネヘンニ ナリノ シ
鈞	ヒトシイノ キン
釿	タチキルノ キン
鈔	スクイトルノ ショー
鈬	タクノ リャクジノ タク
鈕	ボタンノ チュー
鈑	イタガネノ バン
鉞	カネヘンノノ マサカリ
鉗	カンシブンベンノ カン
鉅	オオキイノ キョ
鉉	カネヘンニ ゲンノ ゲン
鉤	ヒキメカギハナノ カギ
鉈	マキワリノ ナタ
銕	クロガネノ テツ
鈿	ウズメノミコトノ ウズメ
鉋	カンナノ カン
鉐	カナヘンニ イシノ セキ
銜	クツワノ カン
銖	カネヘンニ シュノ シュ
銓	ハカルノ セン
銛	モリウチノ モリ
鉚	カネヘンニ ーノ リュー
鋏	カネヘンノ ハサミ
銹	サビノ シュー
銷	トケルノ ショー
鋩	キッサキノ ボー
錏	シゴロノ ア
鋺	カナマリノ エン
鍄	カネヘンニ キョーノ キョー
錮	テサゲキンコノ コ
錙	メカタノタンイノ シ
錢	ゼニノ キュージノ セン
錚	ドラノ ソー
錣	シコロノ テイ
錺	カネヘンニ ヨシノ カザリ
錵	カネヘンニ ハナノ ニエ
錻	カネヘンニ ブノ ブリキ
鍜	カネヘンニ ヒマノ ツクリノ カ
鍠	カネヘンニ コーノ コー
鍼	ハリキューノ ハリ
鍮	ゴーキンシンチューノ チュー
鍖	カネヘンニ ジンノ チン
鎰	カネヘンニ マツ カギノ イツ
鎬	シノギヲ ケズルノ シノギ
鎭	シズメルノ キュージノ チン
鎔	イガタノ ヨー
鎹	カネヘンニ オクルノ カスガイ
鏖	ミナゴロシノ オー
鏗	カネヘンニ カタイノ コー
鏨	タガネノ サン
鏥	カネヘンニ ヤドノ シュー
鏘	カネヘンニ ショーノ ショー
鏃	カネヘンノノ ゾク
鏝	ヤキゴテノ コテ
鏐	イシユミノヘリノ リュー
鏈	クサリノ レン
鏤	チョーシンルコツノ ル
鐚	ビタイチモンノ ビタ
鐔	ツバノ タン
鐓	イシヅキノ タイ
鐃	ドー ニョーバチノ ニョー
鐇	カネヘンニ バンノ ハン
鐐	クサリノ リョー
鐶	ユビワノ カン
鐫	ノミノ セン
鐵	シンニッテツノ テツ
鐡	テツノイジノ テツ
鐺	コジリノ トー
鑁	ウマノクビカザリノ バン
鑒	カガミノイジノ カン
鑄	イルノ キュージノ チュー
鑛	アラガネノ キュージノ コー
鑠	カクシャクトスルノ シャク
鑢	カネヘンニ エンリョノ エンノ ヤスリ
鑞	スズノ ロー
鑪	イロリノ ロ
鈩	イロリノ リャクジノ ロ
鑰	カギノ ヤク
鑵	ブリキカンノ カン
鑷	セッシノ セツ
鑽	ケンサンヲ ツムノ サン
鑚	キリノ サン
鑼	ドラノ ラ
鑾	スズノ ラン
钁	クワノ カク
鑿	ノミノ ノミ
閂	カンヌキノ カン
閇	トジルノイジノ ヘイ
閊	モンガマエニ ヤマノ ツカエル
閔	ウレエル ニビンノ ビン
閖	モンガマエニ ミズノ ユレル
閘	スイモンノ コー
閙	サワガシイノトゼーノ ドー
閠	モンガマエニ タマノ ギョク
閨	ケイシューノ ケイ
閧	カチドキノ コー
閭	リョコーノ リョ
閼	トドメルノ エン
閻	エンマダイオーノ エン
閹	キョセイスルノ エン
閾	シゲキ イキチノ イキ
闊	ウカツノ カツ
濶	ウカツノ カツ
闃	シスカノ ケキ
闍	アジャリノ ジ
闌	タケナワノ ラン
闕	モンガマエニ カケルノ ツクリノ ケツ
闔	モンノトビラノ コー
闖	チンニューシャノ チン
關	セキノ キュージノ カン
闡	アキラカノ セン
闥	モンガマエニ タツノ タツ
闢	テンチカイビャクノ ビャク
阡	ミチノ セン
阨	フサガル ケワシイノ ヤク
阮	インノ コクメイノ ゲン
阯	アトノ シ
陂	ツツミノ ハ
陌	コザトヘンニ ヒャクノ ハク
陏	コザトヘンニ アリノ タ
陋	ガンメイコローノ ロー
陷	オチイルノイジノ カン
陜	ヤマアイノ キョー
陞	ノボルノ ショー
陝	センセイショーノ セン
陟	ノボルノ チョク
陦	コザトヘンニ ジュノ トー
陲	ホトリノ スイ
陬	ヘキスーノチノ スー
隍	ホリノ コー
隘	アイロノ アイ
隕	インセキノ イン
隗	コザトヘンニ オニ ケワシイノ カイ
險	ケワシイノ キュージノ ケン
隧	トンネルノズイノ ズイ
隱	カクレルノ キュージタイノ イン
隲	サダメルノ シツ
隰	サワチノ シツ
隴	オカノ ロー
隶	オヨブノ タイ
隸	シタガーノ キュージノ レイ
隹	フルトリノ スイ
雎	ジンメイ ハンショノ ショ
雋	スグレタノ シュン
雉	ユミヤノノ キジ
雍	ヤワラグノ ヨー
襍	コロモヘンニ シューノ ゾー
雜	マジルノ キュージノ ザツ
霍	ニワカノ カク
雕	ブンシンチョーリョーノ チョー
雹	ヒョーハクノ ハク
霄	ソラノ ショー
霆	イカズチノ テイ
霈	オオアメノ ハイ
霓	ニジノ ゲイ
霎	シバシノソーノ ショー
霑	ウルオスノ テン
霏	モヤノ ヒ
霖	リンウノ リン
霙	ミゾレマジリノ ミゾレ
霤	アマダレノ リュー
霪	ナガアメノ イン
霰	アメアラレノ アラレ
霹	ヘキレキノ ヘキ
霽	コーフーセイゲツノ セイ
霾	ツチグモリノ バイ
靄	アサモヤノ モヤ
靆	アイダイノ タイ
靈	タマノ キュージノ レイ
靂	ヘキレキノ レキ
靉	アイタイノ アイ
靜	シズカノ キュージノ セイ
靠	タガウノ コー
靤	オモテニノ ニキビ
靦	メンヘンニ ミルノ テン
靨	エクボノ ヨー
勒	ミロクボサツノ ロク
靫	ジンノイジノ ジン
靱	シツガイジンタイノ ジン
靹	カワヘンニ ーチノ トモ
鞅	ムナガイノ オー
靼	ナメシガワノ タン
鞁	カワヘンニ カワノ ヒ
靺	カワヘンニ スエノ マツ
鞆	トモヒコノ トモ
鞋	カワヘンノ アイ
鞏	キョーマクノ キョー
鞐	カワヘンニ ジョーゲノ コハゼ
鞜	クツノ トー
鞨	カワグツノ カツ
鞦	シリガイノ シュー
鞣	ナメシガワノ ナメ
鞳	ヘキノ トー
鞴	フイゴノ ヒ
韃	カクニノ アツ
韆	カワヘンニ センノ セン
韈	クツシタノ バツ
韋	ブシュノ ナメシガワ
韜	リクトーサンリャクノ トー
韭	ニラノ キョク
齏	ナマスノ セイ
韲	ナマスノイジノ セイ
竟	ヒッキョーノ キョー
韶	ウツクシイノ ショー
韵	ヒビキノイジノ イン
頏	ノドノ コー
頌	ホメルノ ショー
頸	フンケイノマジワリノ ケイ
頤	シュートンイノ イ
頡	クビスジノ キツ
頷	フクムノ ミギニ オオガイノ ガン
頽	タイハイスルノ タイ
顆	カリュージョータイノ カ
顏	カオノ セイジノ ガン
顋	エラノ サイ
顫	フルエルノ セン
顯	アキラノ キュージノ ケン
顰	ヒンシュクヲ カウノ ヒン
顱	カシワヲ イミスル オオガイノ ロ
顴	カンコツノ カン
顳	コメカミノ コメ
颪	フキオロスカゼノ オロス
颯	サッソーノ サツ
颱	フルイノ タイ
颶	ツムジカゼノ ク
飄	ヒョーゼンノ ヒョー
飃	ヒョーノイジノ ヒョー
飆	イヌミッツノ ツムジカゼ
飩	ムシモチノ ドン
飫	チョクヘンニ カナノ ノノ シタニ オオキイノ サカモリ
餃	ギョーザノ ギョー
餉	ユーゲノ ゲ
餒	ウエルノ ダイ
餔	ユーメシノ ホ
餘	アマリノ キュージノ ヨ
餡	アンマンニクマンノ アン
餝	カザリノ ショク
餞	ヨセンカイノ セン
餤	ススメルノ タン
餠	モチノ ヘイ
餬	カユノ コ
餮	ムサボリタベルノ テツ
餽	キガノ キ
餾	ショクヘンニ リューノ リュー
饂	ウドンノ ウン
饉	キキンニミマワメルノ キン
饅	マンジューノ マン
饐	エツノ イ
饋	オクリモノノ キ
饑	ウエルノ キ
饒	ホージョーノ ジョー
饌	ソナエルノ セン
饕	ムサボルノ トー
馗	ショーキサマノ キ
馘	クビキリノ カク
馥	フクイクノ フク
馭	アヤツルノ ギョ
馮	ボーコヒョーガノ ヒョー
馼	ウマヘンニ フミノ ブン
駟	シモシタニオヨバズノ シ
駛	ハヤイノ シ
駝	ラクダノ ダ
駘	シュンプータイトーノ タイ
駑	ドバジューガノ ド
駭	オドロクノ カイ
駮	マダラノ ハク
駱	ラクダノ ラク
駲	ウマヘンニ シューノ シュー
駻	アラウマノ カン
駸	ハヤイノ シン
騁	ハセルノ テイ
騏	キモオイテワロバニノ キリン
騅	アシゲノ スイ
駢	ベンレイノ ベン
騙	ダマスノ ダマ
騫	アヤマチノ ケン
騷	サワグノ キュージノ ソー
驅	カケルノ キュージノ ク
驂	ソエウマノ サン
驀	バクシンスルノ バク
驃	シラカゲノ ヒョー
騾	ラバノ ラ
驕	キョーマンノ キョー
驍	ツヨイノ ギョー
驛	ステーションノイタイジノ エキ
驗	シルシノ キュージノ ケン
驟	ニワカノ シュー
驢	ロバノ ロ
驥	キビニフスノ キ
驤	ウマヘンニ ジョーノ ジョー
驩	ヨロコブノ カン
驫	ウマサンビキノ ヒョー
驪	ナラベルノ リ
骭	ホネヘンニ ホスノ カン
骰	サイコロノサイノ トー
骼	クサッタホネノ カク
髀	ホネヘンニ イヤシイノ モモノ ヒ
髏	ドクロノ ロ
髑	ドクロノ ドク
髓	スネノ キュージノ ズイ
體	カラダノ キュージノ タイ
髞	タカイニソーノ ソー
髟	カミガシラノ ヒョー
髢	カモジノ テイ
髣	ホーフツノ ホー
髦	タレガミノ ボー
髯	ヒゲノ ゼン
髫	ウナイノ チョー
髮	カミノ キュージノ ハツ
髴	ホーフツノ フツ
髱	タバノ ホー
髷	チョンマゲノ マゲ
髻	タブサノ キツ
鬆	コツソショーショーノ ショー
鬘	カツラノ マン
鬚	ヒゲクジラノ ヒゲ
鬟	モトドリノ カン
鬢	ミミギワノ カミノケノ ビン
鬣	タテガミノ リョー
鬥	トーガマエノ トー
鬧	サワグノ ドー
鬨	カチドキノ ドキ
鬩	セメグノ ケキ
鬪	タタカウノ キュージノ トー
鬮	クジノ キュー
鬯	ユブクロノ チョー
鬲	カマノ カク
魄	キハクニミチタノ ハク
魃	カンバツノ バツ
魏	ギシワジンデンノ ギ
魍	チミモーリョーノ モー
魎	チミモーリョーノ リョー
魑	チミモーリョーノ チ
魘	ウナサレルノ エン
魴	サカナノ ホー
鮓	スシノ サ
鮃	サカナノ ヒラメノ ヒョー
鮑	カイノ アワビ
鮖	サカナノ カジカ
鮗	サカナノ コノシロ
鮟	サカナノ アンコー
鮠	サカナノ ハヤノ ガイ
鮨	ニギリズシノ シ
鮴	サカナノ メバル
鯀	サカナヘンニ ケイノ コン
鯊	サカナノ ハゼ
鮹	サカナノ タコノ ショー
鯆	サカナノ イルカノ ホ
鯏	サカナノ ウグイ
鯑	サカナノ カズノコ
鯒	サカナノ コチ
鯣	サカナヘンニ ボーエキノ エキノ スルメ
鯢	サンショーウオノ ゲイ
鯤	サカナノ ハラゴノ コン
鯔	サカナノ ボラ
鯡	サカナノ ニシンノ ヒ
鰺	サカナヘンニ マイルノ コジノ アジ
鯲	サカナノ ドジョー
鯱	サカナヘンニ トラノ シャチ
鯰	サカナノ ナマズ
鰕	サカナノ エビノ カ
鰔	サカナノ タラノ カン
鰉	サカナノ ヒガイノ コー
鰓	サカナノ エラ
鰌	サカナノ ドジョーノ シュー
鰆	サカナノ サワラノ シュン
鰈	サカナノ カレイ
鰒	サカナノ アワビノ フク
鰊	サカナノ ニシン
鰄	サカナノ イ
鰮	サカナヘン イワシノ イミノ オン
鰛	イワシノ イジノ オン
鰥	カンカコドクノ カン
鰤	ブリノ コドモノ イナダ
鰡	サカナニ トドマルノ リュー
鰰	サカナノ ハタハタ
鱇	サカナノ アンコーノ コー
鰲	ドーブツノ スッポンノ ゴー
鱆	サカナノ タコノ ショー
鰾	ウキブクロノ ヒョー
鱚	サカナノ キス
鱠	サカナヘン ナマズノ イミノ カイ
鱧	サカナノ ハモノ レイ
鱶	サカナノ フカ
鱸	サカナノ スズキノ ロ
鳧	トリノ カモノ フ
鳬	カモノ ゾクジノ フ
鳰	トリノ ニオ
鴉	カラスノ ア
鴈	カリノ イジノ ガン
鳫	カリノ リャクジノ ガン
鴃	トリノ モズノ ケキ
鴆	トリノ チン
鴪	トブトリノ イツ
鴦	トリノ オシドリノ オー
鶯	ウグイスノ キュージノ オー
鴣	トリノ シャコノ コ
鴟	トリノ フクローノ シ
鵄	キンシノ シ
鴕	ダチョーノ ダ
鴒	トリノ セキレイノ レイ
鵁	トリノ ゴイサギノ コー
鴿	トリノ イエバトノ コー
鴾	トリノ トキノ ボー
鵆	トリノ チドリ
鵈	ミミヘンニ トリノ チョー
鵝	ワレノ ミギニ トリ ガチョーノ ガ
鵞	ワレノ シタニ トリ ガチョーノ ガ
鵤	ツノヘンニ トリノ イカルガ
鵑	タオサドリノ ケン
鵐	シトドノ ブ
鵙	トリノ モズノ ケキ
鵲	ムカシニノ カササギ
鶉	トリノ ウズラ
鶇	トリノ ツグミノ トー
鶫	ツグミノ イジノ トー
鵯	トリノ ヒヨドリ
鵺	ヌエノ ヤ
鶚	トリノ ミサゴ
鶤	トーマルノ ウン
鶩	トリノ アヒル
鶲	オキナノ ミギニ トリノ ヒタキ
鷄	ニワトリノ キュージノ ケイ
鷁	ミズドリノ ゲキ
鶻	トリノ ハヤブサノ コツ
鶸	トリノ ヒワノ ジャク
鶺	トリ セキレイノ セキ
鷆	ヨタカノ キュージノ テン
鷏	トリノ ヨタカノ テン
鷂	トリノ ハシタカノ ヨー
鷙	トリノ アラドリノ シ
鷓	トリノ シャコノ シャ
鷸	トリノ カワセミ
鷦	トリノ ミソサザイノ ショー
鷭	トリノ ハンノ バン
鷯	トリノ ヨシキリノ リョー
鷽	トリノ ウソ
鸚	トリノ オームノ オー
鸛	トリノ コーノトリ
鸞	シンランショーニンノ ラン
鹵	ロカクノ ロ
鹹	シオノ カン
鹽	シオノ セイジノ エン
麁	アライノ ゾクジノ ソ
麈	オオシカノ シュ
麋	オオジカノ ビ
麌	オジカノ ゴ
麒	シマウマノ キ
麕	キンシューノ キン
麑	カノコノ ゲイ
麝	ジャコーノ ジャ
麥	ムギノ キュージノ バク
麩	フスマノ フ
麸	フスマノ イジノ フ
麪	ソバノ メンノ メイ
麭	タベモノノ パン
靡	イッセイヲ フービスルノ ビ
黌	マナビヤノ コー
黎	レイメイノ レイ
黏	ネバルノ ネン
黐	キビヘン モチノキノ モチ
黔	クロイノ ケン
黜	シリゾケルノ チュツ
點	テンノ キュージノ テン
黝	アオグロイノ ユー
黠	ワルガシコイノ カツ
黥	イレズミノ ゲイ
黨	トーノ キュージノ トー
黯	ダイニ クロイノ アン
黴	バイキンノ バイ
黶	ホクロノ イミノ エン
黷	ケガレルノ トク
黹	ブシュノ フツノ チ
黻	ヒザカケノ フツ
黼	アヤ フツヘンニ オギナウノ ホ
黽	ブシュノ ベンノ ボー
鼇	オオガメノ イミノ ゴー
鼈	ベッコーノ ベツノ スッポン
皷	ツヅミノ イジノ コ
鼕	ツヅミノ オトノ トー
鼡	ネズミノ リャクジノ ソ
鼬	ネズミニノ イタチ
鼾	ハナニノ イビキ
齊	キュージ イッセイノ セイ
齒	ハノ キュージノ シ
齔	ハガワリノ シン
齣	ヒトコマノ コマ
齟	ソゴヲ キタスノ ソ
齠	ハガワリノ チョー
齡	ヨワイノ キュージノ レイ
齦	ハグキノ ギン
齧	ナマカジリノ カジ
齬	ソゴヲ キタスノ ゴ
齪	コダワルノ サク
齷	アクサクノ アク
齲	ムシバノ ウ
齶	ハヘンノ ハグキノ ガク
龕	ズシノ ガン
龜	カメノ キュージノ キ
龠	フエ ブシュノ ヤク
堯	ツチミッツ キュージノ ギョー
槇	キヘンニ シンジツノ シン ノ マキ
遙	ゾクジ ハルカ カナタノ ハルカ
瑤	キュージ オーヘンニ ハルカノ タマ
凜	ヒキシマル セイジノ リン
熙	ヒロマル アキラカ セイジノ キ
纊	イトヘンニ ヒロサノ キュージ ワタ
褜	サイボーノ ボーノ シタニ コロモ
鍈	カネヘンニ エイユーノ エイ
銈	カネヘンニ ツチヲ フタツ カサネタ ケイ
蓜	クサカンムリニ ケハイノ ハイ
俉	ニンベンニ カンスージノ ゴノ シタニ クチ
炻	ヒヘンニ ジシャクノ イシ
昱	ニチノ シタニ ドクリツノ リツ
棈	キヘンニ アオノ キュージ
鋹	カネヘンニ ナガサノ チョー
曻	ヒラビノ シタニ ソムク セン
彅	ユミヘンニ マエノ キュージノ シタニ カタナ ナギ
丨	タテボー ジョーゲニ ツーズル
仡	ニンベンニ コジキノ コー イサマシイ
仼	ニンベンニ ダイオーノ オー
伀	ニンベンニ オーヤケノ コー
伃	ニンベンニ ヨテイノ ヨ
伹	ニンベンニ ソシキノ ソノ ツクリ
佖	ニンベンニ ヒッショーノ カナラズ タダシイ
侒	ニンベンニ アンゼンノ アン
侊	ニンベンニ ヒカル
侚	ニンベンニ ジョージュンノ ジュン
侔	ニンベンニ カタカナノ ムノ シタニ ドーブツノ ウシ ヒトシイ
俍	ニンベンニ ヨシワルシノ ヨイ
偀	エイゴノ エイノ ゾクジ
倢	ニンベンニ マツゲノ ツクリ ハヤイ
俿	ニンベンニ ドーブツノ トラ
倞	ニンベンニ キョートノ キョー ツヨイ
偆	ニンベンニ シュンカシュートーノ ハル
偰	ニンベンニ ケイヤクノ ケイノ キュージ
偂	ニンベンニ マエノ キュージ
傔	ニンベンニ カネルノ ドージ シタガウ
僴	ニンベンニ ジカンノ カン
僘	ニンベンニ オショーノ ショーノ キュージニ ボクヅクリ
兊	オーヤケノ シタニ ニンニョー
兤	ヒカリノ ミギニ ヒロサノ キュージ
冝	ワカンムリニ ソシキノ ソノ ツクリ
冾	ニスイニ ゴードーノ ゴー
凬	ツクエノ ナカニ イチト ニチヲ カサネル
刕	カタナノ シタニ カタナガ フタツ
劜	チカラノ ミギニ レイギノ レイノ ツクリ
劦	チカラノ シタニ チカラガ フタツ
勀	コクフクスルノ コクノ ミギニ チカラ
勛	キョーインノ インノ ミギニ チカラ
匀	ヘイキンノ キンノ ツクリ
匇	ツツミガマエニ カタカナノ タ
匤	ハコガマエノ ナカニ マガタマノ タマ
卲	メシツカイノ メスノ ミギニ フシズクリ
厓	ガンダレニ ツチヲ フタツ カサネタ ケイ ガケ
厲	ガンダレニ スージノ マンノ キュージ トイシ
叝	キョネンノ キョノ ミギニ オヨブノ キュージ
﨎	ブンショーノ ブント フルトリヲ ナラベ シタニ マタ
咜	クチヘンニ ブッダノ ダノ ツクリ
咊	クチヘンニ ノギノ カ
咩	クチヘンニ ドーブツノ ヒツジ
哿	クワエルノ シタニ フカノーノ カ
喆	ダイキチノ キチヲ フタツ ナラベル シル
坙	イチニ マガリガワト ツチヲ カサネル
坥	ツチヘンニ ソシキノ ソノ ツクリ
垬	ツチヘンニ トモニスルノ キョー
埈	ツチヘンニ スグレル シュンノ ツクリ
埇	ツチヘンニ オケノ ツクリ
﨏	ツチヘンニ ケイコクノ タニ
塚	カイズカノ ツカノ キュージ
增	ゾーカスルノ ゾー フエルノ キュージ
墲	ツチヘンニ アルナシノ ナシ
夋	スルガノ スルノ ツクリ
奓	オーキイノ シタニ タスーノ オーイ
奛	オーキイノ シタニ アカルイ
奝	オーキイノ シタニ シューイノ シューノ キュージ オーイ
奣	テンタイノ テンノ シタニ アカルイ
妤	オンナヘンニ ヨテイノ ヨ ウツクシイ
妺	オンナヘンニ フンマツノ マツ
孖	コヘンニ コドモノ コ フタゴ
寀	ウカンムリニ サイヨースルノ サイノ キュージノ ツクリ
甯	ウカンムリニ ココロト モチイルヲ カサネル
寘	ウカンムリニ シャシンノ シンノ キュージ
寬	カンダイノ カンノ キュージ
尞	チリョーノ リョーノ ヤマイダレヲ ノゾク
岦	ヤマカンムリニ チューリツノ リツ
岺	ヤマカンムリニ リツリョーノ リョー
峵	ヤマヘンニ ウカンムリノ ヒロイ
崧	ヤマカンムリニ マツタケノ マツ
嵓	ヤマカンムリニ サクヒンノ ヒン
﨑	ヤマヘンニ タツノ シタニ クチト ハネボー サキノ ゾクジ
嵂	ヤマカンムリニ カイリツノ リツ
嵭	ヤマヘンニ カタワラノ ホー クズレル
嶸	ヤマヘンニ サカエルノ キュージ ケワシイ
嶹	ヤマヘンニ チョージュノ ジュノ キュージ
巐	ヤマカンムリニ タカマルト ノボルヲ ナラベル
弡	ユミヘンニ キョジンノ キョノ キュージ
弴	ユミヘンニ キョーネンノ キョー
彧	アルイワノ アルノ ホコニノ ミッツ
德	ジントクノ トクノ キュージ ノリ
忞	ジンブンノ ブンノ シタニ ココロ ツトメル
恝	ケイヤクノ ケイノ キュージノ オオキイノ カワリニ ココロ
悅	マンエツノ エツノ キュージ ヨロコブ
悊	キョクセツノ セツノ シタニ ココロ
惞	リッシンベント オノノ キン カケルヲ ナラベル
惕	リッシンベンニ ヤサシイノ エキ ツツシム
愠	リッシンベンニ ニチノ シタニ サラ
惲	リッシンベンニ グンジンノ グン
愑	リッシンベンニ イサマシイノ キュージ
愷	リッシンベンニ ヨロイノ ツクリ
愰	リッシンベンニ ニチノ シタニ ヒカリ
憘	リッシンベンニ ヨロコブ
戓	アルイワノ アルノ クチノ シタノ イチヲ ノゾク
抦	テヘンニ  オーヘイノ ヘイノ ツクリ
揵	テヘンニ ケンチクノ ケン
摠	テヘンニ ソーゴーノ ソーノ キュージノ ツクリ
撝	テヘンニ タメノ キュージ
擎	ソンケイノ ケイノ シタニ テアシノ テ
敎	キョーイクノ キョーノ キュージ
昀	ニチヘンニ ツツミガマエ カンスージノ ニ
昕	ニチヘンニ オノノ キン
昻	ニチノ シタニ ムカエルノ ツクリ アガル
昉	ニチヘンニ ホーコーノ ホー アキラカ
昮	ニチノ シタニ セイコースルノ コー
昞	ニチヘンニ オーヘイノ ヘイノ ツクリ
昤	ニチヘンニ リツリョーノ リョー
晥	ニチヘンニ カンセイノ カン
晗	ニチヘンニ フクムノ ガン
晙	ニチヘンニ シュンビンノ シュンノ ツクリ
晴	テンキノ ハレ キュージ
晳	ブンセキノ セキノ シタニ ニチ アキラカ
暙	ニチヘンニ シュンカシュートーノ ハル
暠	ニチノ シタニ タカイノ コー
暲	ニチヘンニ モンショーノ ショー
暿	ニチヘンニ ヨロコブノ キ
曺	メグミノ ココロノ カワリニ ニチ
朎	ツキヘンニ リツリョー リョー
朗	イチローノ ローノ キュージ
杦	キヘンニ ヒサシイノ キュー
枻	キヘンニ セケンノ セ
桒	カンスージノ ジュー クサカンムリ ショクブツノ キヲ カサネル
柀	キヘンニ ヒフノ カワ
栁	キヘンニ ユーベ フシヅクリヲ ナラベル
桄	キヘンニ ヒカル
棏	キヘンニ ソントクノ トクノ ツクリ
﨓	キヘンニ クサカンムリニ フチャクスルノ ツク
楨	キヘンニ テイソーノ テイ
﨔	キヘンニ マイキョノ キョ
榘	クケイノ クノシタニ ショクブツノ キ
槢	キヘンニ ガクシューノ シューノ キュージ
樰	キヘンニ テンキノ ユキノ キュージ
橫	オーダンホドーノ オーノ キュージ
橆	アルナシノ ナイノ レンガノ カワリニ ハヤシ
橳	キヘンニ ショーハイノ ショーノ キュージ
橾	キヘンニ クチミッツノ シタニ ショクブツノ キ
櫢	キヘンニ スーガクノ スーノ キュージ
櫤	キヘンニ タケカンムリニ マエノ キュージ
毖	ヒカクノ ヒノシタニ カナラズ
氿	サンズイニ カンスージノ ク
汜	サンズイニ ヘビドシノ ミ
沆	サンズイニ テイコーノ コーノ ツクリ
汯	サンズイニ カイナノ コー
泚	サンズイニ ココ キヨイ
洄	サンズイニ カイスーノ カイ
涇	サンズイニ ヨコイチ マガリガワ ズコーノ コーヲ カサネル
浯	サンズイニ カンスージノ ゴニ クチ
涖	サンズイニ クライドリノ クライ
涬	サンズイニ シアワセノ コー
淏	サンズイニ ニチノ シタニ テンクーノ テン
淸	シミズノ シ キヨイノ キュージ
淲	サンズイニ ドーブツノ トラノ コ
淼	ミズガ ミッツ
渹	サンズイニ ツツミガマエニ ゲンゴノ ゲン
湜	サンズイニ コレノ ゼ キヨイ
渧	サンズイニ ミカドノ キュージ
渼	サンズイニ ウツクシイノ ビ
溿	サンズイニ コハンノ ハンノ キュージ
澈	サンズイニ ソダテルノ ミギニ ボクヅクリ
澵	サンズイニ アタラシイノ シン
濵	サンズイニ ゲイヒンノ ヒンノ ゾクジ
瀅	サンズイニ ヒフタツ ワカンムリニ タマ
瀇	サンズイニ ヒロサノ キュージ
瀨	アサセノ セノ キュージ
炅	ニチノ シタニ ヒ
炫	ニチヘンニ クロートノ ゲン カガヤク
焏	クチ シューリョーノ リョー マタヲナラベ レンガ
焄	キミノ シタニ レンガ カンバシイ
煜	ヒヘンニ ニチノ シタニ タツ
煆	ヒヘンニ キューカノ カノ ツクリ
煇	ヒヘンニ グンジンノ グン
凞	ニスイト オニ オノレヲ ナラベ シタニ レンガ
燁	ヒヘンニ ハナヤカノ キュージ
燾	コトブキノ キュージニ レンガ
犱	ケモノヘンニ ウシワカマルノ マル
犾	ケモノヘンニ ドーブツノ イヌ
猤	ケモノヘンニ ショクブツノ アオイノ ツクリ
猪	イノシシノ キュージ
獷	ケモノヘンニ ヒロサノ キュージ
玽	オーヘンニ モンクノ ク
珉	オーヘンニ ミンシューノ ミン
珖	オーヘンニ ヒカル
珣	オーヘンニ ジョージュンノ ジュン
珒	オーヘンニ フデヅクリ
琇	オーヘンニ ユーシューノ シュー
珵	オーヘンニ シンテイスルノ テイノ キュージ
琦	オーヘンニ キスーノ キ
琪	オーヘンニ ソノイチノ ソ
琩	オーヘンニ オヒサマノ ヒヲ フタツ カサネル
琮	オーヘンニ シューハノ シュー シルシ
瑢	オーヘンニ アナカンムリニ シューゴーノ ゴーノ イチガ ナイモノ
璉	オーヘンニ ツラナルノ キュージ マツリノ ドーグ
璟	オーヘンニ ケシキノ ケイ
甁	カビンノ ビンノ キュージ
畯	タヘンニ スグレル シュンノ ツクリ
皂	シロイノ シタニ カンスージノ ナナ ドングリ
皜	シロイノ ミギニ タカイ シロイ
皞	シロイノ ミギニ シロ オオキイ カンスージノ ジューヲ カサネル
皛	シロガ ミッツ アキラカ
皦	シロイノ ミギニ ハゲシイノ ツクリ シロイ
益	リエキノ エキノ キュージ
睆	メヘンニ マットースルノ カン
劯	イシヘンニ チカラ ツヨイ
砡	イシヘンニ タマノ ギョク
硎	イシヘンニ バツノ キョッケイノ ケイ
硤	イシヘンニ ハサム コー
硺	イシヘンニ キツツキノ タクノ キュージノ ツクリ
礰	イシヘンニ ケイレキノ レキノ キュージ
礼	ブレイノ レイノ コジ
神	カミサマノ カミノ キュージ
祥	キッショー ショーノ キュージ
禔	シメスノ ミギニ コレノ ゼ
福	ユーフクノ フクノ キュージ
禛	シメスノ ミギニ シャシンノ シンノ キュージ
竑	タツヘンニ カイナノ コー
竧	タツヘンニ シンタイノ ミ
靖	タツヘンニ アオノ キュージ
竫	タツヘンニ センソーノ ソーノ キュージ
箞	タケカンムリニ マキモノノ マキノ キュージ タワメル
精	セイミツノ セイノ キュージ
絈	イトヘンニ イロノ シロ ハチマキ
絜	セイケツノ ケツノ キュージノ ツクリ キヨイ
綷	イトヘンニ オワル ソツギョーノ ソツ
綠	ミドリノ キュージノ ロク
緖	ユイショノ ショノ キュージ
繒	イトヘンニ ミゾーノ ソー キヌ
罇	ホトギノ ミギニ ソンケイノ ソンノ キュージ
羡	ヒツジノ ブシュノ シタニ ツギ
羽	ウモーノ ウノ キュージ
茁	クサカンムリニ デル
荢	クサカンムリニ ウジノ ウ
荿	クサカンムリニ セイジュクノ セイ
菇	クサカンムリニ オンナノ ミギニ フルイ
菶	クサカンムリニ ホーノーノ ホー
葈	クサカンムリニ ダイケイノ ダイ キヲ カサネル
蒴	クサカンムリニ ツイタチノ サク
蕓	クサカンムリニ クモノ ウン
蕙	クサカンムリニ メグミノ キュージ
蕫	クサカンムリニ ワラベノ ドー
﨟	クサカンムリニ ツキノ ミギニ ナンゾノ カツ
薰	カオリノ キュージ
蘒	クサカンムリニ ノギノ ミギニ カメノ キュージ
﨡	ムシヘンニ イキルノ セイ
蠇	ムシヘンニ ヨロズノ キュージ
裵	ケッテンノ ヒニ コロモノ ハイノ ホンジ
訒	ゴンベンニ ヤイバノ キュージ アヤム
訷	ゴンベンニ モーシアゲルノ シン
詹	クドクドト イウノ セン
誧	ゴンベンニ テンポノ ポノ ツクリ
誾	モンガマエニ ゲンゴノ ゲン オダヤカ
諟	ゴンベンニ コレノ ゼ
諸	モロモロノ ショノ キュージ
諶	ゴンベンニ ハナハダノ ジン
譓	ゴンベンニ メグミノ キュージ
譿	ゴンベンニ ケイガンノ ケイノ キュージ
賰	カイヘンニ シュンカシュートーノ ハル
賴	シンライノ ライ タヨルノ キュージ
贒	カシコイ ケンノ コジ
赶	ソーギョーニ ヒモノノ ヒ
﨣	ソーギョーニ トマスノ ト
軏	クルマヘンニ イチノ シタニ ヒトアシ クサビ
﨤	シンニューニ オヨブノ キュージ
逸	イツダツノ イツノ キュージ
遧	シンニョーニ ブンショーノ ショー
郞	イチローノ ローノ キュージ
都	ミヤコノ キュージ
鄕	キョーリノ キョーノ ゾクジ
鄧	トザンノ ノボルノ ミギニ オオザト
釚	カネヘンニ キューカンチョーノ キュー
釗	カネヘンニ リットー
釞	カネヘンニ ハイル
釭	カネヘンニ ズコーノ コー
釮	カネヘンニ サイノーノ サイ スルドイ
釤	カネヘンニ サンヅクリ オオガマ
釥	カネヘンニ チイサイ
鈆	カネヘンニ コーヘイノ コー
鈐	カネヘンニ キョーノ イマ クサビ
鈊	カネヘンニ ココロ
鈺	カネヘンニ マガタマノ ギョク
鉀	カネヘンニ コーオツノ コー
鈼	カネヘンニ ドーサノ サノ ツクリ
鉎	カネヘンニ ナマタマゴノ ナマ
鉙	カネヘンニ クチノ シタニ カタカナノ ハ
鉑	カネヘンニ シラガノ シロ
鈹	カネヘンニ ヒフノ カワ
鉧	カネヘンニ オカアサンノ ハハ
銧	カネヘンニ ヒカリ
鉷	カネヘンニ トモニスルノ キョー
鉸	カネヘンニ マジル ハサミ
鋧	カネヘンニ ケンガクノ ケン
鋗	カネヘンニ キヌノ ツクリ
鋙	カネヘンニ カンスージノ ゴノ シタニ クチ クイチガウ
鋐	カネヘンニ ウカンムリノ ヒロイ
﨧	カネヘンニ オヤフコーノ コー
鋕	カネヘンニ シガンノ シ
鋠	カネヘンニ タツノ シン
鋓	カネヘンニ リソクノ リ スルドイ
錥	カネヘンニ タイイクノ イク
錡	カネヘンニ キミョーノ キ
鋻	カタイ ケンコノ ケンノ ツクリノ シタニ カネ
﨨	カネヘンニ シアワセノ コー
錞	カネヘンニ キョーネンノ キョー
鋿	カネヘンニ オショーノ ショーノ キュージ
錝	カネヘンニ シューハノ シュー
錂	カネヘンニ ヒシガタノ ヒシノ ツクリ
鍰	カネヘンニ ココニノ エン
鍗	カネヘンニ コーテイノ テイ
鎤	カネヘンニ ヒニ ヒカリノ アキラ
鏆	カネヘンニ ツラヌク カンツーノ カン
鏞	カネヘンニ ゼイノ ソヨーチョーノ ヨー オオガネ
鏸	カネヘンニ メグミノ キュージ スルドイ
鐱	カネヘンニ キケンノ ケン キュージノ ツクリ
鑅	カネヘンニ ハンジョー サカエルノ キュージ
鑈	カネヘンニ ナンジ シカリ
閒	モンガマエノ ナカニ ニクヅキ
隆	リューセイノ リュー タカシノ キュージ
﨩	コザトヘンニ イシガキジマノ シマ
隝	コザトヘンニ バードノ トリ
隯	コザトヘンニ チョージュノ ジュノ キュージ
霳	アメカンムリニ リューセイノ リューノ キュージ
霻	アメカンムリニ ユタカノ ホー
靃	アメカンムリニ フルトリ フルトリ
靍	アメカンムリニ フルトリニ トリ
靏	アメカンムリニ トリノ ツル
靑	アオイノ セイジ セイ
靕	タダシイノ ミギニ アオイノ セイジ
顗	ヤマノ シタニ マメ ミギニ オーガイ
顥	ケシキノ ケイノ ミギニ オーガイ
飯	ゴハンノ ハン メシノ キューカツジ
飼	シイクスルノ シ カウノ キューカツジ
餧	ショクヘンノ キュージタイニ イインカイノ イ ヤシナウ 
館	トショカンノ カン ヤカタノ キューカツジ
馞	カオリノ ミギニ ジュー ワカンムリ コドモノ コヲ カサネル
驎	ウマヘンニ ウロコノ ツクリ
髙	タカイノ コー ハシゴダカ
髜	タカイニ ノボルノ ショー
魵	サカナヘンニ ワケル フン
魲	サカナヘンニ トビラノ トノ キュージ
鮏	サカナヘンニ ナマタマゴノ ナマ
鮱	サカナヘンニ ローフーフノ ロー
鮻	サカナヘンニ スグレル シュンノ ツクリ
鰀	サカナヘンニ ココニノ エン
鵰	シューイノ シューノ キュージニ トリ ワシ
鵫	ショクタクノ タクニ トリ
鶴	トリノ ツルノ ゾクジ
鸙	フエノ ヤクノ ミギニ トリ
黑	イロノ クロ キュージ
