#Simplified Chinese (China) characterDescriptions.dic 
#A part of NonVisual Desktop Access (NVDA)
#URL: http://www.nvda-project.org/



阿	锕姨的锕,婀胶的婀
凹	凹	凸的凹	,挖突的挖
扒	巴开的巴,爬开的爬
耙	爸地的爸,爬子的爬
柏	勃林的勃,松百的百
膀	背绑的绑,旁胱的旁
磅	谤秤的谤,旁礴的旁
蚌	棒壳的棒,泵埠的泵
剥	包皮的包,波靴的波
薄	雹厚的雹,勃弱的勃
堡	保垒的保,土瀑的瀑,吴补的补
暴	爆风的爆,瀑露的瀑
辟	复必的必,开譬的譬
臂	闭膀的闭,哥臂	的哥
便	便	利的变,骈宜的骈
伯	百百的百,勃父的驳
泊	湖泼的泼,停搏的搏
卜	补卦的补,萝啵的啵
参	餐加的餐,嵾疵的嵾,人身的身
藏	躲藏	的藏	,葬族的葬
厕	测所的测,茅思的思
查	调碴的碴,姓扎的扎
差	插错的插,参疵的疵,拆事的拆
拆	钗开的钗,擦烂污的擦
掺	搀和的搀,闪手的闪
颤	站栗的站,忏抖的忏
长	偿短的偿,掌大的掌
朝	潮代的潮,招气的招
嘲	晁讽的晁,召扎的召
称	趁心的趁,撑呼的撑
澄	成清的成,镫清的镫
匙	汤持的持,钥师的师
尺	齿寸的齿,工扯的扯
仇	畴敌的畴,姓求的求
臭	臭	味的臭	,乳秀的秀
传	船达的船,馔记的馔
幢	石床的床,撞房的撞
绰	超起的超,绰	号的辍
撮	搓合的搓,细左的左
大	大	小的大	,代夫的代
单	眈双的眈,蝉于的蝉,姓善的善
弹	炮但的但,谈力的谈
得	德到的德,得	亏的得	
的	目弟的	弟,助词的	的	
翟	姓宅的宅,迪车的迪
底	抵片的抵,虚词的的
地	土第的第,助词的的
佃	电户的电,田作的田
调	钓查的钓,条和的条
侗	动族的动,童蒙的童
都	蔸好的蔸,督市的督
读	牍写的牍,句斗的斗
度	高肚的肚,揣夺的夺
顿	停盾的盾,墨毒的毒
囤	粮盾的盾,屯积的屯
恶	饿劣的饿,可物的物
番	翻号的翻,攀禺的攀
佛	仿服的服,佛	像的佛	
脯	果斧的斧,胸葡的葡
盖	概子的概,姓舸的舸
镐	号督的号,铁搞的搞
胳	嘎肢的嘎,哥膊的哥
蛤	蛤	蟆的蛤	,隔蜊的隔
给	给	你的给	,己养的己
龟	乌规的规,均裂的军
夯	夯	土的夯	,笨蛋的笨
呵	喝斥的喝,助词的啊
和	何好的何,湖牌的蝴,或泥的或
貉	丘何的何,豪绒的豪
嘿	黑黑的黑,墨然的墨
还	孩有的孩,环原的环
会	会	议的会	,快计的快
豁	或然的或,华拳的华
夹	加板的加,嘎肢的嘎
贾	商古的古,姓甲的甲
槛	门砍的砍,建车的建
降	糨临的糨,投详的详
嚼	嚼	舌的嚼	,举决的决
脚	腿绞的绞,主决的决
角	缴渡的缴,决瑟的决
剿	搅灭的搅,抄说的抄
桔	橘柑的橘,截梗的截
解	姐决的姐,姓谢的谢
藉	借口的借,狼急的急
颈	脖耿的耿,井追的井
咀	举决的举,嘴脸的嘴
句	具子的具,勾践的勾
觉	决醒的决,睡叫的叫
咖	嘎喱的嘎,喀啡的喀
卡	佧车的佧,卡	壳的卡	
咯	比洛的洛,哥吱的哥,卡血的卡
楷	凯模的凯,接木的接
扛	扛	枪的扛	,刚台的刚
壳	外壳	的壳	,地翘的翘
咳	壳嗽的壳,嗨呀的嗨
吭	坑声的坑,引航的航
傀	轨奇的轨,傀	儡的傀	
括	包括	的扩,挺瓜的瓜
腊	蜡月的蜡,西肉的西
勒	乐令的乐,勒	紧的勒	
乐	乐	观的叻,因月的月
肋	类骨的类,鳓推的仂
棱	棱	角的楞,穆零的零
俩	伎两的两,俩	人的俩	
潦	潦	倒的潦	,水涝的涝
了	助词的了	,钌解的钌
碌	忙路的路,六碡的六
露	漏面的漏,路天的路
陆	陆	地的路,大写的六
率	蟀领的蟀,效律的律
绿	律色的律,路林的路
纶	涤轮的轮,关巾的关
落	蜡下的蜡,珞后的珞,酪架的酪
络	涝子的涝,联洛的洛
埋	霾葬的霾,瞒怨的瞒
脉	麦搏的麦,默默的默
么	怎么	的么	,来吗的吗
没	煤有的煤,默洛的默
秘	蜜书的蜜,必鲁的必
泌	分蜜的蜜,必阳的必
模	磨范的磨,毪样的毪
摩	磨擦的磨,妈仨的妈
抹	妈布的妈,抹	黑的抹	
哪	哪	个的哪	,呢吒的呢
那	钠么的钠,内个的内
娜	纳纳的钠,婀挪的挪
呢	尼绒的尼,助词的呢	
尿	脲液的脲,虽泡的虽
弄	玩弄	的弄	,弄	堂的弄	
疟	疟	疾的虐,药子的药
哦	哦	哦	的哦	,吟俄的俄
刨	咆坑的咆,报刀的报
炮	泡火的泡,包干的包
屏	平幕的平,饼息的炳
迫	破切的破,迫	击的迫	
埔	黄的埔	,大不的不
朴	普素的普,破硝的破,姓瓢的瓢
曝	暴光的暴,瀑晒的瀑
瀑	瀑	布的瀑	,报河的报
奇	基数的基,其怪的其
乾	前坤的前,竿湿的竿
强	倔降的降,墙大的墙
鞘	鞭烧的烧,刀峭的峭
茄	茄	子的茄	,雪加的加
区	屈别的屈,姓欧的欧
圈	牛倦的倦,悛点的悛
炔	乙缺的缺,姓贵的贵
雀	麻确的确,家巧的巧
塞	鳃子的腮,阻瑟的瑟
色	瑟彩的瑟,色	子的色	
莎	梭草的梭,纱帷的纱
刹	古汊的汊,沙车的沙
杉	沙木的沙,山木的山
裳	长裙的长,衣裳	的伤
梢	树梢	的烧,木臊的臊
沈	审阳的审,陈淀的陈
省	反醒的醒,省	级的省	
盛	成饭的成,盛	大的胜
石	石	头的十,五但的但
什	神么的神,时锦的时
食	食	品的十,喂四的四
术	白竹的竹,技术	的数
数	频硕的硕,树字的树
衰	等催的催,摔弱的摔
谁	谁	人的谁	,谁	是的谁	
说	说	话的说	,游税的税,悦耳的悦
伺	次候的次,窥四的四
似	是的的是,似	乎的四
宿	一朽的朽,住宿	的速
缩	素砂的素,缩	短的梭
倘	常佯的常,倘	若的躺
提	低防的低,题高的题
褪	蜕色的蜕,褪	去的褪	
驮	驮	马的陀,剁子的剁
拓	开唾的唾,踏片的踏
尾	伟巴的伟,以巴的以
蔚	蔚	蓝的蔚	,育县的育
涡	锅河的锅,挝流的挝
铣	洗床的铣	,显铁的显
洗	喜涤的喜,姓显的显
戏	演戏	的戏	,呜呼的呼
虾	大瞎的瞎,蛤蟆的蛤
厦	大煞的煞,下门的下
吓	恐贺的贺,吓	唬的下
纤	先维的先,欠夫的欠
巷	巷	口的象,沆道的沆
削	波靴的靴,消皮的箫
校	叫对的叫,学笑的笑
挟	颊持的颊,邀斜的斜
行	航列的杭,形维的陉
嘘	失声的失,需气的需
畜	牲畜	的绌,续牧的序
血	鲜写的写,雪汗的雪
寻	旬找的旬,寻	思的寻	
咽	呜业的业,淹喉的淹
烟	淹火的淹,因火的因
俞	姓俞	的鱼,学位的术
吁	呼育的预,需叹的须
咱	杂家的杂,咱	们的咱	
凿	开凿	的凿	,确作的作
择	选则的则,宅菜的宅
曾	增祖的增,曾	经的层
扎	扎	根的扎	,咂彩的咂
轧	噶账的噶,讶花的讶,闸钢的闸
栅	光山的山,栅	栏的炸
咋	渣呼的渣,咋	办的咋	,炸舌的炸
粘	年膜的年,毡贴的毡
折	蛇本的蛇,辄扣的辄
吱	嘎之的之,姿声的姿
殖	骨尸的尸,值民的值
峙	对至的至,繁是的是
种	重田的重,肿子的肿
重	崇复的崇,众量的众
爪	找牙的找,爪	子的爪	
拽	业拉的业,拽	车的拽	
赚	赚	钱的赚	,攥人的攥
椎	垂铁的垂,追骨的追
着	昭急的昭,啄众的啄
仔	牛崽的崽,紫细的紫
柞	炸水的炸,柞	蚕的柞	
乜	姓臬的臬,咩斜的咩
嘏	福气的古,福气的甲
剡	善县的善,眼利的眼
仡	歌佬的仡	,仡	立的仡	
伧	苍俗的苍,寒伧	的抻
佚	亡意的意,轮流的迭
伽	嘎马的嘎,加耶的加,茄蓝的茄
佴	二停的二,姓耐的耐
俟	末其的其,四机的四
偈	计陀的计,节勇的节
偻	铝辈的铝,佝偻	的楼
僮	壮族的壮,童子的童
诘	曲折的级,反节的节
诶	叹词的诶	,诶	声的诶	
陂	杯池的杯,黄皮的皮,坡陀的坡
郇	姓郇	的郇	,旬国的旬
圩	需镇的需,唯田的唯
圻	疆界的垠,银边的银
坻	宝底的抵,坻	岛的迟
垌	田栋的栋,同冢的同
埤	脾增的脾,土劈的劈
芫	研荽的研,原花的原
芾	蔽费的费,米服的服
苣	取卖的取,莴句的句
苕	红勺的勺,条子的条
茜	人名的茜	,欠草的欠
荑	题草的题,移草的移
茈	凫辞的辞,仔草的仔
荠	计菜的计,荸荠	的荠	
荥	型阳的型,迎经的迎
莩	草幅的幅,死人的殍
莞	东管的管,晚尔的晚
莨	浪菪的浪,属亮的亮
蓼	草高的路,蓼	科的蓼	
尢	古体的尤,本字的汪
拗	奥口的奥,执拗	的拗	
拶	攒指的攒,咂迫的咂
捋	旅顺的旅,罗起的罗
掴	乖打的乖,国打的国
忒	叉特的特,推差的推
叨	涛扰的涛,叨	唠的叨	
呔	口音的呔	,呔	叹的呔	
吡	痞斥的痞,比啶的比
呗	叹词的呗	,败唱的败
呲	资牙的资,疵人的疵
喏	唱惹的惹,诺叹的诺
啁	招哳的招,周啾的周
啜	姓踹的踹,啜	泣的辍
嗒	叭嗒	的嗒	,踏然的踏
喔	哦唷的哦,喔	喔	的喔	
嗄	煞哑的煞,嗄	刻的嗄	
嗌	异咽的异,嗌	气的嗌	
嗨	黑呦的黑,嗨	哟的嗨	
噌	撑红的撑,噌	吃的噌	
噱	决笑的决,学头的学
嚓	擦擦的擦,喀插的插
囝	简儿的简,囡子的囡
圜	原圈的原,转环的环
帱	愁帐的愁,稻覆的稻
峒	崆峒	的同,洞室的洞
峤	叫道的叫,桥角的桥
崴	崴	脚的崴	,高山的巍
徵	争求的征,乐谱的指
忪	惺松的松,中萌的萌
阏	饿塞的饿,烟之的之
阚	姓看的看,喊虎的喊
泷	咙水的咙,双水的双
泺	血颇的颇,洛水的洛
浍	快水的快,哕河的哕
浒	水浒	的虎,许湾的许
渑	绳水的绳,渑	池的沔
湮	淹没的淹,纸音的音
湫	脚隘的脚,秋水的秋
溱	琴潼的琴,真水的真
澹	谈台的谈,澹	泊的但
孱	灿头的灿,蝉弱的缠
骀	驽台的台,代荡的代
骠	标马的标,票骑的票
纥	回合的合,线割的割
缏	带变的变,篇缝的篇
缪	绸谋的谋,姓妙的妙,纰谬的谬
缲	敲边的敲,缫丝的缫
玢	宾玉的宾,纹理的分
珩	航磨的航,横玉的横
珲	浑春的浑,瑷挥的挥
枞	木匆的匆,宗阳的宗
栎	橡力的力,月阳的月
柁	房驼的驼,木惰的惰
栝	刮楼的刮,隐扩的扩
桧	贵柏的贵,秦绘的绘
椹	桑甚的甚,砧板的砧
楂	山渣的渣,胡茬的茬
槟	宾子的斌,兵榔的兵
炅	炯炯的炯,姓柜的柜
贲	必临的毕,虎奔的奔
犍	尖牛的尖,前为的前
挲	妈撒的仨,磨梭的梭
歙	设县的设,吸气的吸
焯	火桌的桌,焯	菜的抄
熨	育帖的育,韵斗的韵
焘	国涛的涛,到载的到
禅	缠林的缠,善让的善
恁	嫩些的嫩,您早的您
慝	逆新的逆,隐特的特
沓	一达的达,杂塌的塌
砉	需然的需,砉	声的花
硌	落石的落,各牙的各
町	挺畦的挺,畹玎的玎
钯	金把的把,耙地的耙
钿	金电的电,铜田的田
铊	秤驮的驮,金它的它
铛	撑锅的撑,当锒的当
铤	金定的定,挺走的挺
铫	摇锄的摇,药掉的药
镡	新器的新,姓谈的谈
鹄	葫鸟的葫,目标的骨
疸	黄胆的胆,疙瘩的瘩
瘥	矬病的矬,虿病的虿
窨	印井的印,熏茶的熏
袷	夹衣的夹,掐袢的掐
褚	姓褚	的褚	,主丝的主
裼	袒西的西,婴裼	的替
裨	必益的必,皮将的皮
矜	关夫的关,今持的今
覃	谈思的谈,姓秦的秦
颉	仓节的节,鞋航的鞋
颌	格口的格,合口的合
蚵	科螂的科,蚵	虫的蚵	
蛸	肖烧的烧,螵销的销
蝤	求蛴的求,由蛑的由
笮	姓笮	的笮	,昨桥的昨
筠	军连的军,云竹的云
糁	身儿的身,糁	米的伞
綮	肯庆的庆,起衣的起
繇	籀辞的籀,徭异的徭,自由的由
趄	趔趄	的妾,趑居的居
酢	酬作的作,酢	草的促
酾	施酒的施,酾	酒的酾	
蹊	西径的西,期跷的期
觜	孜速的孜,嘴缴的嘴
靓	镜美的镜,亮丽的亮
霰	伞但的伞,霰	冰的现
龈	齿龈	的狺,肯青的肯
黾	敏勉的敏,猛窟的猛
隹	催字的催,追鸟的追
瞿	渠塘的渠,句然的句
鲭	争鱼的争,青鱼的青
鹘	鹘	仑的鹘	,古鸟的古
髟	发山的山,须标的标
麽	这么的么,幺麽	的麽	
麇	军鲁的军,群集的裙
臑	必闹的闹,儿鳖的儿
争	斗争	的争	
嗟	嗟	乎的嗟	
鬈	全发的鬈	
祢	姓迷的祢	
踮	踮	脚的踮	
蚝	豪油的蚝	
饧	饧	面的饧	
欹	期测的欹	
鬲	鬲	津的鬲	
萆	艹卑的萆	
孛	博戾的孛	
姱	姱	女的姱	
魄	体魄	的魄	
盟	同盟	的盟	
徊	徘徊	的徊	
蓝	蓝	色的蓝	
緼	赤黄的緼	
啊	叹词的啊	
呆	呆	板的呆	
恫	恫	吓的恫	
蹲	蹲	下的蹲	
橙	橙	色的橙	
屹	屹	然的屹	
埃	埃	及的埃	
挨	挨	打的挨	
哎	哎	呀的哎	
唉	唉	声的唉	
哀	悲哀	的哀	
皑	白雪的皑	
癌	癌	症的癌	
蔼	和蔼	的蔼	
矮	高矮	的矮	
艾	草艾	的艾	
碍	妨碍	的碍	
爱	爱	护的爱	
隘	狭隘	的隘	
鞍	马鞍	的鞍	
氨	氨	气的氨	
安	安	全的安	
俺	俺	们的俺	
按	按	照的按	
暗	黑暗	的暗	
岸	岸	边的岸	
胺	月胺	的胺	
案	案	件的案	
肮	肮	脏的肮	
昂	昂	扬的昂	
盎	盎	然的盎	
敖	敖	包的敖	
熬	熬	炼的熬	
翱	翱	翔的翱	
袄	皮袄	的袄	
傲	骄傲	的傲	
奥	奥	秘的奥	
懊	懊	悔的懊	
澳	澳	洲的澳	
芭	芭	蕉的芭	
岜	芭山的岜	
捌	大写的捌	
叭	哈叭	的叭	
吧	好吧	的吧	
笆	篱笆	的笆	
八	八	个的八	
疤	疮疤	的疤	
巴	尾巴	的巴	
拔	提拔	的拔	
跋	跋	涉的跋	
靶	枪靶	的靶	
把	把	握的把	
坝	土坝	的坝	
霸	霸	道的霸	
罢	罢	免的罢	
爸	爸	爸	的爸	
白	白	色的白	
百	百	万的百	
摆	摆	动的摆	
佰	人百的佰	
败	失败	的败	
拜	拜	年的拜	
稗	稗	子的稗	
斑	斑	纹的斑	
班	排班	的班	
搬	搬	开的搬	
扳	扳	子的扳	
般	一般	的般	
颁	颁	发的颁	
板	木板	的板	
版	出版	的版	
扮	打扮	的扮	
拌	搅拌	的拌	
伴	同伴	的伴	
瓣	花瓣	的瓣	
半	半	边的半	
办	办	公的办	
绊	绊	脚的绊	
邦	邻邦	的邦	
帮	帮	助的帮	
梆	梆	子的梆	
榜	榜	样的榜	
绑	绑	架的绑	
棒	棍棒	的棒	
镑	英镑	的镑	
傍	傍	晚的傍	
谤	诽谤	的谤	
苞	苞	米的苞	
胞	同胞	的胞	
包	书包	的包	
褒	褒	奖的褒	
雹	冰雹	的雹	
保	保	护的保	
饱	吃饱	的饱	
宝	宝	贵的宝	
抱	拥抱	的抱	
报	报	刊的报	
豹	虎豹	的豹	
鲍	鲍	鱼的鲍	
爆	爆	炸的爆	
杯	杯	子的杯	
碑	碑	帖的碑	
悲	悲	哀的悲	
卑	卑	亢的卑	
北	北	方的北	
辈	前辈	的辈	
背	背	面的背	
贝	宝贝	的贝	
钡	钡	餐的钡	
倍	倍	数的倍	
狈	狼狈	的狈	
备	备	用的备	
惫	疲惫	的惫	
焙	焙	粉的焙	
被	被	动的被	
奔	奔	跑的奔	
苯	甲苯	的苯	
本	本	来的本	
笨	笨	拙的笨	
崩	崩	溃的崩	
绷	绷	带的绷	
甭	甭	用的甭	
泵	水泵	的泵	
蹦	蹦	跳的蹦	
迸	迸	发的迸	
逼	逼	迫的逼	
鼻	鼻	子的鼻	
比	比	较的比	
鄙	鄙	人的鄙	
笔	毛笔	的笔	
彼	彼	此的彼	
碧	碧	绿的碧	
蓖	蓖	麻的蓖	
蔽	掩蔽	的蔽	
毕	毕	业的毕	
毙	毙	命的毙	
毖	毖	后的毖	
币	钱币	的币	
庇	庇	护的庇	
痹	病痹	的痹	
闭	关闭	的闭	
敝	敝	处的敝	
弊	弊	病的弊	
必	必	要的必	
壁	墙壁	的壁	
避	躲避	的避	
陛	陛	下的陛	
鞭	鞭	打的鞭	
边	边	界的边	
编	编	织的编	
贬	贬	低的贬	
扁	扁	平的扁	
变	变	化的变	
卞	姓卞	的卞	
辨	辨	别的辨	
辩	辩	论的辩	
辫	辫	子的辫	
遍	普遍	的遍	
标	标	点的标	
彪	彪	炳的彪	
膘	肉膘	的膘	
表	表	面的表	
鳖	鱼鳖	的鳖	
憋	憋	气的憋	
别	别	人的别	
瘪	瘪	三的瘪	
彬	彬	彬	的彬	
斌	文彬的斌	
濒	濒	临的濒	
滨	海滨	的滨	
宾	宾	客的宾	
摈	摈	斥的摈	
兵	兵	卒的兵	
冰	冰	雪的冰	
柄	木柄	的柄	
丙	丙	丁的丙	
秉	秉	工的秉	
饼	月饼	的饼	
炳	彪炳	的炳	
病	疾病	的病	
并	并	且的并	
玻	玻	璃的玻	
菠	菠	菜的菠	
播	播	种的播	
拨	拨	开的拨	
钵	衣钵	的钵	
波	波	浪的波	
博	博	士的博	
勃	勃	勃	的勃	
搏	搏	斗的搏	
铂	铂	金的铂	
箔	苇箔	的箔	
帛	玉帛	的帛	
舶	船舶	的舶	
脖	脖	子的脖	
膊	胳膊	的膊	
渤	渤	海的渤	
驳	驳	斥的驳	
捕	逮捕	的捕	
哺	哺	乳的哺	
补	补	充的补	
埠	本埠	的埠	
不	不	要的不	
布	布	匹的布	
步	步	枪的步	
簿	帐簿	的簿	
部	部	分的部	
怖	恐怖	的怖	
擦	擦	亮的擦	
猜	猜	测的猜	
裁	裁	缝的裁	
材	木材	的材	
才	才	能的才	
财	财	物的财	
睬	理睬	的睬	
踩	踩	踏的踩	
采	采	摘的采	
彩	色彩	的彩	
菜	白菜	的菜	
蔡	姓蔡	的蔡	
餐	早餐	的餐	
蚕	蚕	丝的蚕	
残	残	废的残	
惭	惭	愧的惭	
惨	悲惨	的惨	
灿	灿	烂的灿	
苍	苍	天的苍	
舱	船舱	的舱	
仓	仓	库的仓	
沧	沧	海的沧	
操	操	场的操	
糙	糙	米的糙	
槽	水槽	的槽	
曹	姓曹	的曹	
草	青草	的草	
策	策	划的策	
侧	侧	面的侧	
册	册	子的册	
测	测	量的测	
层	层	次的层	
蹭	磨蹭	的蹭	
插	插	入的插	
叉	叉	子的叉	
茬	一茬	的茬	
茶	茶	碗的茶	
碴	十碴	的碴	
搽	搽	粉的搽	
察	察	觉的察	
岔	岔	路的岔	
诧	诧	异的诧	
柴	柴	火的柴	
豺	豺	狼的豺	
搀	搀	扶的搀	
蝉	蝉	蜕的蝉	
馋	嘴馋	的馋	
谗	谗	言的谗	
缠	缠	绕的缠	
铲	铲	子的铲	
产	产	品的产	
阐	阐	明的阐	
昌	昌	盛的昌	
猖	猖	狂的猖	
场	操场	的场	
尝	品尝	的尝	
常	经常	的常	
偿	补偿	的偿	
肠	肠	胃的肠	
厂	厂	房的厂	
敞	敞	亮的敞	
畅	畅	通的畅	
唱	唱	歌的唱	
倡	提倡	的倡	
超	超	过的超	
抄	抄	书的抄	
钞	钞	票的钞	
潮	潮	流的潮	
巢	巢	穴的巢	
吵	吵	闹的吵	
炒	炒	面的炒	
车	马车	的车	
扯	拉扯	的扯	
撤	撤	换的撤	
掣	掣	肘的掣	
彻	彻	底的彻	
澈	清澈	的澈	
郴	郴	县的郴	
臣	臣	服的臣	
辰	辰	时的辰	
尘	尘	土的尘	
晨	清晨	的晨	
忱	热忱	的忱	
沉	沉	没的沉	
陈	陈	旧的陈	
趁	趁	机的趁	
衬	衬	衣的衬	
撑	撑	伞的撑	
城	城	市的城	
成	成	功的成	
呈	呈	文的呈	
乘	乘	法的乘	
程	程	度的程	
惩	惩	办的惩	
诚	诚	心的诚	
承	承	认的承	
逞	逞	能的逞	
骋	驰骋	的骋	
秤	秤	盘的秤	
吃	吃	饭的吃	
痴	痴	心的痴	
持	持	久的持	
池	池	水的池	
迟	迟	到的迟	
弛	松弛	的弛	
驰	驰	名的驰	
耻	耻	辱的耻	
齿	牙齿	的齿	
侈	奢侈	的侈	
赤	赤	红的赤	
翅	翅	膀的翅	
斥	排斥	的斥	
炽	炽	烈的炽	
充	充	满的充	
冲	冲	动的冲	
虫	虫	子的虫	
崇	崇	拜的崇	
宠	宠	爱的宠	
抽	抽	水的抽	
酬	酬	劳的酬	
畴	范畴	的畴	
踌	踌	伫的踌	
稠	稠	密的稠	
愁	忧愁	的愁	
筹	筹	备的筹	
绸	丝绸	的绸	
瞅	瞅	见的瞅	
丑	丑	态的丑	
初	初	级的初	
出	出	来的出	
橱	橱	柜的橱	
厨	厨	房的厨	
躇	踌躇	的躇	
锄	锄	头的锄	
雏	雏	形的雏	
滁	滁	县的滁	
除	除	法的除	
楚	清楚	的楚	
础	基础	的础	
储	储	备的储	
矗	矗	立的矗	
搐	抽搐	的搐	
触	触	动的触	
处	处	理的处	
揣	揣	测的揣	
川	四川	的川	
穿	穿	越的穿	
椽	椽	子的椽	
船	船	只的船	
喘	喘	气的喘	
串	串	联的串	
疮	疮	疤的疮	
窗	窗	口的窗	
床	床	单的床	
闯	闯	祸的闯	
创	创	造的创	
吹	吹	气的吹	
炊	炊	具的炊	
捶	捶	打的捶	
锤	锤	子的锤	
垂	垂	直的垂	
春	春	天的春	
椿	椿	树的椿	
醇	醇	化的醇	
唇	唇	齿的唇	
淳	淳	朴的淳	
纯	纯	洁的纯	
蠢	愚蠢	的蠢	
戳	戳	穿的戳	
疵	求疵	的疵	
茨	茨	菰的茨	
磁	磁	力的磁	
雌	雌	雄的雌	
辞	辞	职的辞	
慈	慈	善的慈	
瓷	瓷	器的瓷	
词	词	组的词	
此	此	地的此	
刺	刺	刀的刺	
赐	赐	给的赐	
次	次	品的次	
聪	聪	明的聪	
葱	大葱	的葱	
囱	烟囱	的囱	
匆	匆	匆	的匆	
从	从	来的从	
丛	丛	林的丛	
凑	凑	合的凑	
粗	粗	细的粗	
醋	吃醋	的醋	
簇	簇	拥的簇	
促	促	进的促	
蹿	上蹿	的蹿	
篡	篡	夺的篡	
窜	逃窜	的窜	
摧	摧	残的摧	
崔	姓崔	的崔	
催	催	促的催	
脆	脆	弱的脆	
瘁	尽瘁	的瘁	
粹	国粹	的粹	
淬	淬	火的淬	
翠	翡翠	的翠	
村	村	庄的村	
存	存	在的存	
寸	尺寸	的寸	
磋	切磋	的磋	
搓	搓	洗的搓	
措	措	施的措	
挫	挫	折的挫	
错	错	误的错	
搭	搭	桥的搭	
达	达	到的达	
答	回答	的答	
瘩	瘩	背的瘩	
打	打	击的打	
歹	歹	徒的歹	
傣	傣	族的傣	
戴	戴	花的戴	
带	带	领的带	
殆	殆	尽的殆	
代	代	表的代	
贷	贷	款的贷	
袋	口袋	的袋	
待	等待	的待	
逮	逮	捕的逮	
怠	怠	工的怠	
耽	耽	误的耽	
担	担	任的担	
丹	丹	方的丹	
郸	含郸	的郸	
掸	掸	土的掸	
胆	胆	谅的胆	
旦	元旦	的旦	
氮	氮	气的氮	
但	但	是的但	
惮	忌惮	的惮	
淡	咸淡	的淡	
诞	诞	辰的诞	
蛋	鸡蛋	的蛋	
当	当	时的当	
挡	挡	住的挡	
党	党	派的党	
荡	动荡	的荡	
档	档	案的档	
刀	刀	子的刀	
捣	捣	毁的捣	
蹈	舞蹈	的蹈	
倒	打倒	的倒	
岛	岛	屿的岛	
祷	祷	告的祷	
导	报导	的导	
到	到	达的到	
稻	稻	米的稻	
悼	悼	念的悼	
道	道	路的道	
盗	盗	匪的盗	
德	德	国的德	
蹬	蹭蹬	的蹬	
灯	灯	火的灯	
登	登	高的登	
等	等	待的等	
瞪	瞪	眼的瞪	
凳	板凳	的凳	
邓	姓邓	的邓	
堤	堤	坝的堤	
低	高低	的低	
滴	滴	水的滴	
迪	启迪	的迪	
敌	敌	人的敌	
笛	笛	子的笛	
狄	姓狄	的狄	
涤	涤	纶的涤	
嫡	嫡	系的嫡	
抵	抵	抗的抵	
蒂	草蒂	的蒂	
第	第	几的第	
帝	帝	王的帝	
弟	弟	弟	的弟	
递	传递	的递	
缔	缔	约的缔	
颠	颠	沛的颠	
掂	掂	量的掂	
滇	滇	剧的滇	
碘	碘	酒的碘	
点	点	火的点	
典	典	型的典	
靛	靛	青的靛	
垫	靠垫	的垫	
电	电	灯的电	
甸	缅甸	的甸	
店	商店	的店	
惦	惦	念的惦	
奠	奠	定的奠	
淀	沉淀	的淀	
殿	宫殿	的殿	
碉	碉	堡的碉	
叼	嘴叼	的叼	
雕	雕	刻的雕	
凋	凋	谢的凋	
刁	刁	难的刁	
掉	掉	换的掉	
吊	吊	车的吊	
钓	钓	钩的钓	
跌	跌	落的跌	
爹	爹	爹	的爹	
碟	碟	子的碟	
蝶	蝴蝶	的蝶	
迭	更迭	的迭	
谍	间谍	的谍	
叠	虫叠	的叠	
丁	丙丁	的丁	
盯	盯	梢的盯	
叮	叮	嘱的叮	
钉	钉	子的钉	
顶	头顶	的顶	
鼎	鼎	力的鼎	
锭	金锭	的锭	
定	决定	的定	
订	订	货的订	
丢	丢	失的丢	
东	东	方的东	
冬	冬	天的冬	
董	董	事的董	
懂	懂	得的懂	
动	动	静的动	
栋	栋	梁的栋	
冻	冻	冰的冻	
洞	洞	穴的洞	
兜	网兜	的兜	
抖	抖	动的抖	
斗	斗	争的斗	
陡	陡	峭的陡	
豆	豆	芽的豆	
逗	逗	乐的逗	
痘	牛痘	的痘	
督	督	促的督	
毒	毒	气的毒	
犊	牛犊	的犊	
独	单独	的独	
堵	堵	塞的堵	
睹	目睹	的睹	
赌	赌	搏的赌	
杜	杜	绝的杜	
镀	镀	金的镀	
肚	肚	子的肚	
渡	渡	河的渡	
妒	妒	忌的妒	
端	端	正的端	
短	长短	的短	
锻	锻	炼的锻	
段	分段	的段	
断	断	绝的断	
缎	锦缎	的缎	
堆	土堆	的堆	
兑	兑	现的兑	
队	队	伍的队	
对	对	面的对	
墩	墩	布的墩	
吨	吨	位的吨	
敦	敦	促的敦	
钝	迟钝	的钝	
盾	矛盾	的盾	
遁	远遁	的遁	
掇	拾掇	的掇	
哆	哆	嗦的哆	
多	多	少的多	
夺	抢夺	的夺	
垛	窕垛	的垛	
躲	躲	藏的躲	
朵	花朵	的朵	
跺	跺	脚的跺	
舵	掌舵	的舵	
剁	剁	肉的剁	
惰	惰	性的惰	
堕	堕	落的堕	
蛾	蛾	子的蛾	
峨	巍峨	的峨	
鹅	鹅	蛋的鹅	
俄	俄	国的俄	
额	额	头的额	
讹	讹	传的讹	
娥	宫娥	的娥	
厄	险厄	的厄	
扼	扼	首的扼	
遏	遏	制的遏	
鄂	湘鄂	的鄂	
饿	挨饿	的饿	
恩	恩	情的恩	
而	而	且的而	
儿	儿	子的儿	
耳	耳	朵的耳	
尔	偶尔	的尔	
饵	鱼饵	的饵	
洱	洱	海的洱	
二	二	个的二	
贰	大写的贰	
发	发	展的发	
罚	处罚	的罚	
筏	竹筏	的筏	
伐	砍伐	的伐	
乏	缺乏	的乏	
阀	军阀	的阀	
法	方法	的法	
珐	珐	琅的珐	
藩	藩	邦的藩	
帆	帆	船的帆	
翻	翻	身的翻	
樊	姓樊	的樊	
矾	矾	石的矾	
钒	钒	钢的钒	
繁	繁	荣的繁	
凡	平凡	的凡	
烦	烦	恼的烦	
反	反	面的反	
返	返	回的返	
范	模范	的范	
贩	小贩	的贩	
犯	犯	法的犯	
饭	饭	店的饭	
泛	泛	滥的泛	
坊	牌坊	的坊	
芳	芳	草的芳	
方	方	法的方	
肪	脂肪	的肪	
房	房	间的房	
防	防	备的防	
妨	妨	碍的妨	
仿	仿	佛的仿	
访	访	问的访	
纺	纺	线的纺	
放	放	大的放	
菲	菲	箔的菲	
非	是非	的非	
啡	咖啡	的啡	
飞	飞	鸟的飞	
肥	肥	料的肥	
匪	土匪	的匪	
诽	诽	谤的诽	
吠	犬吠	的吠	
肺	心肺	的肺	
废	废	品的废	
沸	沸	点的沸	
费	花费	的费	
芬	芬	芳的芬	
酚	酚	酞的酚	
吩	吩	咐的吩	
氛	气氛	的氛	
分	分	开的分	
纷	纠纷	的纷	
坟	坟	土的坟	
焚	焚	火的焚	
汾	汾	水的汾	
粉	米粉	的粉	
奋	奋	斗的奋	
份	份	子的份	
忿	忿	忿	的忿	
愤	愤	怒的愤	
粪	粪	便的粪	
丰	丰	副的丰	
封	封	锁的封	
枫	枫	叶的枫	
蜂	蜂	蜜的蜂	
峰	高峰	的峰	
锋	尖锋	的锋	
风	风	景的风	
疯	疯	狂的疯	
烽	烽	火的烽	
逢	相逢	的逢	
冯	姓冯	的冯	
缝	缝	补的缝	
讽	讽	刺的讽	
奉	奉	陪的奉	
凤	凤	凰的凤	
否	是否	的否	
夫	夫	人的夫	
敷	敷	衍的敷	
肤	皮肤	的肤	
孵	孵	蛋的孵	
扶	扶	梯的扶	
拂	拂	晓的拂	
辐	车辐	的辐	
幅	幅	度的幅	
氟	氟	气的氟	
符	符	号的符	
伏	起伏	的伏	
俘	俘	虏的俘	
服	服	务的服	
浮	浮	漂的浮	
涪	涪	江的涪	
福	幸福	的福	
袱	包袱	的袱	
弗	弗	未的弗	
甫	台甫	的甫	
抚	抚	摸的抚	
辅	辅	导的辅	
俯	俯	冲的俯	
釜	釜	底的釜	
斧	斧	头的斧	
腑	脏腑	的腑	
府	政府	的府	
腐	腐	败的腐	
赴	赴	会的赴	
副	副	刊的副	
覆	颠覆	的覆	
赋	赋	予的赋	
复	复	杂的复	
傅	师傅	的傅	
付	付	给的付	
阜	务复的阜	
父	父	母的父	
腹	腹	部的腹	
负	负	责的负	
富	丰富	的富	
讣	讣	告的讣	
附	附	近的附	
妇	妇	女的妇	
缚	束缚	的缚	
咐	吩咐	的咐	
噶	噶	厦的噶	
嘎	嘎	嘎	的嘎	
该	应该	的该	
改	改	变的改	
概	大概	的概	
钙	钙	片的钙	
溉	灌溉	的溉	
干	干	部的干	
甘	甘	苦的甘	
杆	木杆	的杆	
柑	柑	桔的柑	
竿	竹竿	的竿	
肝	肝	胆的肝	
赶	赶	跑的赶	
感	感	谢的感	
秆	麦秆	的秆	
敢	勇敢	的敢	
赣	赣	江的赣	
冈	井冈	的冈	
刚	刚	好的刚	
钢	钢	铁的钢	
缸	水缸	的缸	
肛	肛	门的肛	
纲	大纲	的纲	
岗	岗	位的岗	
港	海港	的港	
杠	杠	杆的杠	
篙	竹篙	的篙	
皋	江皋	的皋	
高	高	低的高	
膏	牙膏	的膏	
羔	羔	子的羔	
糕	糕	点的糕	
搞	搞	好的搞	
稿	稿	件的稿	
告	报告	的告	
哥	哥	哥	的哥	
歌	歌	唱的歌	
搁	搁	浅的搁	
戈	干戈	的戈	
鸽	飞鸽	的鸽	
疙	面疙	的疙	
割	割	断的割	
革	革	命的革	
葛	草葛	的葛	
格	格	子的格	
阁	阁	下的阁	
隔	隔	离的隔	
铬	铬	钢的铬	
个	个	人的个	
各	各	位的各	
根	根	本的根	
跟	跟	脚的跟	
耕	耕	地的耕	
更	更	改的更	
庚	庚	子的庚	
羹	羹	匙的羹	
埂	田埂	的埂	
耿	耿	直的耿	
梗	木梗	的梗	
工	工	人的工	
攻	攻	防的攻	
功	功	劳的功	
恭	恭	贺的恭	
龚	姓龚	的龚	
供	供	应的供	
躬	鞠躬	的躬	
公	公	私的公	
宫	宫	殿的宫	
弓	弓	箭的弓	
巩	巩	固的巩	
汞	汞	水的汞	
拱	拱	手的拱	
贡	贡	献的贡	
共	共	同的共	
钩	铁钩	的钩	
勾	勾	引的勾	
沟	水沟	的沟	
苟	苟	安的苟	
狗	狗	熊的狗	
垢	污垢	的垢	
构	构	造的构	
购	购	买的购	
够	够	用的够	
辜	辜	负的辜	
菇	蘑菇	的菇	
咕	咕	东的咕	
箍	铁箍	的箍	
估	估	计的估	
沽	沽	名的沽	
孤	孤	立的孤	
姑	姑	妈的姑	
鼓	敲鼓	的鼓	
古	古	代的古	
蛊	蛊	惑的蛊	
骨	骨	头的骨	
谷	山谷	的谷	
股	股	票的股	
故	故	乡的故	
顾	顾	问的顾	
固	固	定的固	
雇	雇	佣的雇	
刮	刮	风的刮	
瓜	瓜	果的瓜	
剐	刀剐	的剐	
寡	寡	妇的寡	
挂	挂	号的挂	
褂	褂	子的褂	
乖	乖	巧的乖	
拐	拐	弯的拐	
怪	奇怪	的怪	
棺	棺	木的棺	
关	关	系的关	
官	官	员的官	
冠	冠	军的冠	
观	观	看的观	
管	管	理的管	
馆	宾馆	的馆	
罐	罐	头的罐	
惯	习惯	的惯	
灌	灌	溉的灌	
贯	贯	穿的贯	
光	光	明的光	
广	广	大的广	
逛	逛	街的逛	
瑰	瑰	丽的瑰	
规	规	定的规	
圭	圭	臬的圭	
硅	硅	片的硅	
归	归	结的归	
闺	闺	女的闺	
轨	轨	道的轨	
鬼	鬼	魂的鬼	
诡	诡	辩的诡	
癸	癸	干的癸	
桂	桂	树的桂	
柜	柜	台的柜	
跪	跪	下的跪	
贵	贵	族的贵	
刽	子刽	的刽	
辊	闸辊	的辊	
滚	滚	动的滚	
棍	木棍	的棍	
锅	大锅	的锅	
郭	姓郭	的郭	
国	国	家的国	
果	果	子的果	
裹	包裹	的裹	
过	过	往的过	
哈	哈	哈	的哈	
骸	骸	骨的骸	
孩	孩	子的孩	
海	大海	的海	
氦	氦	气的氦	
亥	新亥	的亥	
害	害	怕的害	
骇	骇	然的骇	
酣	酣	畅的酣	
憨	憨	厚的憨	
邯	邯	郸的邯	
韩	姓韩	的韩	
含	包含	的含	
涵	涵	洞的涵	
寒	寒	冷的寒	
函	信函	的函	
喊	呼喊	的喊	
罕	稀罕	的罕	
翰	翰	林的翰	
撼	震撼	的撼	
捍	捍	卫的捍	
旱	干旱	的旱	
憾	遗憾	的憾	
悍	悍	然的悍	
焊	焊	接的焊	
汗	汗	水的汗	
汉	汉	字的汉	
杭	杭	州的杭	
航	航	空的航	
壕	壕	沟的壕	
嚎	嚎	啕的嚎	
豪	豪	华的豪	
毫	毫	毛的毫	
郝	姓郝	的郝	
好	好	坏的好	
耗	耗	费的耗	
号	号	召的号	
浩	浩	大的浩	
喝	喝	水的喝	
荷	荷	花的荷	
菏	菏	泽的菏	
核	核	心的核	
禾	禾	苗的禾	
何	何	必的何	
合	合	成的合	
盒	盒	子的盒	
阂	隔阂	的阂	
河	河	流的河	
涸	甘涸	的涸	
赫	赫	然的赫	
褐	褐	色的褐	
鹤	仙鹤	的鹤	
贺	祝贺	的贺	
黑	黑	色的黑	
痕	痕	迹的痕	
很	很	好的很	
狠	狠	毒的狠	
恨	仇恨	的恨	
哼	哼	哈的哼	
亨	亨	通的亨	
横	横	竖的横	
衡	衡	量的衡	
恒	恒	心的恒	
轰	轰	炸的轰	
哄	哄	骗的哄	
烘	烘	烤的烘	
虹	彩虹	的虹	
鸿	鸿	沟的鸿	
洪	洪	水的洪	
宏	宏	伟的宏	
弘	弘	大的弘	
红	红	色的红	
喉	喉	咙的喉	
侯	侯	爵的侯	
猴	猴	子的猴	
吼	吼	叫的吼	
厚	厚	薄的厚	
候	等候	的候	
后	前后	的后	
呼	呼	喊的呼	
乎	在乎	的乎	
忽	忽	然的忽	
瑚	珊瑚	的瑚	
壶	茶壶	的壶	
葫	葫	芦的葫	
胡	胡	琴的胡	
蝴	蝴	蝶的蝴	
狐	狐	狸的狐	
糊	糊	涂的糊	
湖	湖	水的湖	
弧	弧	光的弧	
虎	老虎	的虎	
唬	唬	人的唬	
护	保护	的护	
互	相互	的互	
沪	京沪	的沪	
户	户	口的户	
花	花	草的花	
哗	哗	变的哗	
华	华	中的华	
猾	狡猾	的猾	
滑	滑	动的滑	
画	图画	的画	
划	划	分的划	
化	文化	的化	
话	说话	的话	
槐	槐	树的槐	
怀	怀	念的怀	
淮	淮	河的淮	
坏	好坏	的坏	
欢	欢	乐的欢	
环	环	绕的环	
桓	谭桓	的桓	
缓	缓	慢的缓	
换	交换	的换	
患	患	难的患	
唤	呼唤	的唤	
痪	瘫痪	的痪	
豢	豢	养的豢	
焕	焕	发的焕	
涣	涣	散的涣	
宦	宦	官的宦	
幻	幻	想的幻	
荒	开荒	的荒	
慌	慌	忙的慌	
黄	黄	色的黄	
磺	硫磺	的磺	
蝗	蝗	虫的蝗	
簧	弹簧	的簧	
皇	皇	帝的皇	
凰	凤凰	的凰	
惶	惊惶	的惶	
煌	辉煌	的煌	
晃	摇晃	的晃	
幌	幌	子的幌	
恍	恍	然的恍	
谎	说谎	的谎	
灰	灰	色的灰	
挥	挥	动的挥	
辉	辉	光的辉	
徽	国徽	的徽	
恢	恢	复的恢	
蛔	蛔	虫的蛔	
回	回	头的回	
毁	毁	灭的毁	
悔	后悔	的悔	
慧	智慧	的慧	
卉	花卉	的卉	
惠	优惠	的惠	
晦	晦	气的晦	
贿	贿	赂的贿	
秽	污秽	的秽	
烩	烩	饼的烩	
汇	汇	报的汇	
讳	忌讳	的讳	
诲	诲	人的诲	
绘	绘	画的绘	
荤	荤	速的荤	
昏	昏	迷的昏	
婚	结婚	的婚	
魂	灵魂	的魂	
浑	浑	浊的浑	
混	混	合的混	
活	活	动的活	
伙	伙	伴的伙	
火	火	红的火	
获	获	得的获	
或	或	者的或	
惑	迷惑	的惑	
霍	霍	乱的霍	
货	货	物的货	
祸	祸	福的祸	
击	打击	的击	
圾	垃圾	的圾	
基	基	础的基	
机	机	器的机	
畸	畸	形的畸	
稽	滑稽	的稽	
积	积	累的积	
箕	簸箕	的箕	
肌	肌	肉的肌	
饥	饥	饿的饥	
迹	踪迹	的迹	
激	激	动的激	
讥	讥	笑的讥	
鸡	鸡	蛋的鸡	
姬	文姬	的姬	
绩	成绩	的绩	
缉	通缉	的缉	
吉	吉	祥的吉	
极	级极	的极	
棘	棘	手的棘	
辑	编辑	的辑	
籍	籍	贯的籍	
集	集	中的集	
及	以及	的及	
急	急	忙的急	
疾	疾	病的疾	
汲	汲	取的汲	
即	即	刻的即	
嫉	嫉	妒的嫉	
级	级	别的级	
挤	拥挤	的挤	
几	几	个的几	
脊	脊	背的脊	
己	自己	的己	
蓟	草蓟	的蓟	
技	技	能的技	
冀	冀	望的冀	
季	季	节的季	
伎	伎	两的伎	
祭	祭	奠的祭	
剂	药剂	的剂	
悸	心悸	的悸	
济	救济	的济	
寄	寄	信的寄	
寂	寂	寞的寂	
计	计	算的计	
记	记	号的记	
既	既	然的既	
忌	忌	讳的忌	
际	国际	的际	
妓	妓	女的妓	
继	继	续的继	
纪	纪	录的纪	
嘉	嘉	庆的嘉	
枷	枷	锁的枷	
佳	佳	品的佳	
家	家	庭的家	
加	加	减的加	
荚	豆荚	的荚	
颊	面颊	的颊	
甲	甲	乙的甲	
钾	磷钾	的钾	
假	假	定的假	
稼	庄稼	的稼	
价	价	格的价	
架	架	子的架	
驾	驾	驶的驾	
嫁	出嫁	的嫁	
歼	歼	灭的歼	
监	监	督的监	
坚	坚	强的坚	
尖	尖	锐的尖	
笺	信笺	的笺	
间	中间	的间	
煎	煎	熬的煎	
兼	兼	职的兼	
肩	肩	膀的肩	
艰	艰	难的艰	
奸	奸	细的奸	
缄	缄	默的缄	
茧	蚕茧	的茧	
检	检	查的检	
柬	请柬	的柬	
碱	酸碱	的碱	
硷	硷	水的硷	
拣	挑拣	的拣	
捡	捡	拾的捡	
简	简	化的简	
俭	俭	朴的俭	
剪	剪	刀的剪	
减	减	法的减	
荐	推荐	的荐	
鉴	鉴	定的鉴	
践	践	踏的践	
贱	贵贱	的贱	
见	看见	的见	
键	键	盘的键	
箭	弓箭	的箭	
件	文件	的件	
健	健	康的健	
舰	舰	艇的舰	
剑	宝剑	的剑	
饯	蜜饯	的饯	
渐	渐	渐	的渐	
溅	溅	落的溅	
涧	山涧	的涧	
建	建	立的建	
僵	僵	直的僵	
姜	姜	女的姜	
将	将	军的将	
浆	浆	糊的浆	
江	江	河的江	
疆	边疆	的疆	
蒋	姓蒋	的蒋	
桨	船桨	的桨	
奖	奖	品的奖	
讲	讲	话的讲	
匠	木匠	的匠	
酱	酱	油的酱	
蕉	香蕉	的蕉	
椒	辣椒	的椒	
礁	礁	石的礁	
焦	焦	土的焦	
胶	橡胶	的胶	
交	交	流的交	
郊	郊	外的郊	
浇	浇	水的浇	
骄	骄	傲的骄	
娇	娇	柔的娇	
搅	搅	拌的搅	
铰	铰	链的铰	
矫	矫	正的矫	
侥	侥	幸的侥	
狡	狡	猾的狡	
饺	饺	子的饺	
缴	缴	获的缴	
绞	绞	盘的绞	
教	教	育的教	
酵	发酵	的酵	
轿	轿	车的轿	
较	比较	的较	
叫	叫	喊的叫	
窖	地窖	的窖	
揭	揭	发的揭	
接	连接	的接	
皆	皆	大的皆	
秸	禾秸	的秸	
街	街	道的街	
阶	阶	梯的阶	
截	截	止的截	
劫	抢劫	的劫	
节	节	日的节	
杰	豪杰	的杰	
捷	捷	报的捷	
睫	眉睫	的睫	
竭	竭	力的竭	
洁	洁	白的洁	
结	结	合的结	
姐	姐	姐	的姐	
戒	戒	烟的戒	
芥	草芥	的芥	
界	界	限的界	
借	借	钱的借	
介	介	绍的介	
疥	疥	疮的疥	
诫	告诫	的诫	
届	换届	的届	
巾	毛巾	的巾	
筋	筋	骨的筋	
斤	斤	两的斤	
金	金	金	的金	
今	今	日的今	
津	天津	的津	
襟	襟	怀的襟	
紧	紧	迫的紧	
锦	锦	绣的锦	
仅	仅	不的仅	
谨	严谨	的谨	
进	进	步的进	
靳	姓靳	的靳	
晋	魏晋	的晋	
禁	禁	止的禁	
近	远近	的近	
烬	灰烬	的烬	
浸	浸	水的浸	
尽	尽	力的尽	
劲	干劲	的劲	
荆	荆	棘的荆	
兢	兢	兢	的兢	
茎	草茎	的茎	
睛	眼睛	的睛	
晶	晶	体的晶	
鲸	鲸	鱼的鲸	
京	北京	的京	
惊	惊	人的惊	
精	精	细的精	
粳	粳	米的粳	
经	经	过的经	
井	井	水的井	
警	警	察的警	
景	风景	的景	
静	安静	的静	
境	环境	的境	
敬	敬	礼的敬	
镜	镜	子的镜	
径	田径	的径	
痉	痉	挛的痉	
靖	靖	康的靖	
竟	竟	然的竟	
竞	竞	赛的竞	
净	干净	的净	
炯	炯	炯	的炯	
窘	窘	态的窘	
揪	揪	斗的揪	
究	究	竟的究	
纠	纠	纷的纠	
玖	大写的玖	
韭	韭	菜的韭	
久	永久	的久	
灸	针灸	的灸	
九	九	个的九	
酒	酒	杯的酒	
厩	马厩	的厩	
救	救	护的救	
旧	新旧	的旧	
臼	臼	齿的臼	
舅	舅	舅	的舅	
咎	引咎	的咎	
就	就	是的就	
疚	内疚	的疚	
鞠	鞠	躬的鞠	
拘	拘	捕的拘	
狙	狙	击的狙	
疽	疽	疮的疽	
居	居	住的居	
驹	马驹	的驹	
菊	菊	花的菊	
局	局	部的局	
矩	规矩	的矩	
举	举	行的举	
沮	沮	丧的沮	
聚	聚	集的聚	
拒	抗拒	的拒	
据	根据	的据	
巨	巨	大的巨	
具	具	体的具	
距	距	离的距	
踞	虎踞	的踞	
锯	锯	开的锯	
俱	俱	全的俱	
惧	惧	怕的惧	
炬	火炬	的炬	
剧	剧	本的剧	
捐	捐	献的捐	
鹃	杜鹃	的鹃	
娟	婵娟	的娟	
倦	疲倦	的倦	
眷	眷	恋的眷	
卷	卷	曲的卷	
绢	绢	丝的绢	
撅	撅	折的撅	
攫	攫	取的攫	
抉	抉	择的抉	
掘	发掘	的掘	
倔	倔	强的倔	
爵	爵	士的爵	
决	决	定的决	
诀	诀	窍的诀	
绝	绝	对的绝	
均	平均	的均	
菌	细菌	的菌	
钧	千钧	的钧	
军	军	队的军	
君	君	子的君	
峻	峻	岭的峻	
俊	英俊	的俊	
竣	竣	工的竣	
浚	浚	河的浚	
郡	郡	县的郡	
骏	骏	马的骏	
喀	喀	插的喀	
开	开	关的开	
揩	揩	油的揩	
凯	凯	旋的凯	
慨	慷慨	的慨	
刊	刊	物的刊	
堪	不堪	的堪	
勘	勘	测的勘	
坎	坎	坷的坎	
砍	砍	柴的砍	
看	看	见的看	
康	健康	的康	
慷	慷	慨的慷	
糠	米糠	的糠	
抗	抵抗	的抗	
亢	亢	进的亢	
炕	火炕	的炕	
考	考	试的考	
拷	拷	打的拷	
烤	烤	火的烤	
靠	靠	背的靠	
坷	坎坷	的坷	
苛	苛	刻的苛	
柯	柯	枝的柯	
棵	棵	儿的棵	
磕	磕	头的磕	
颗	颗	粒的颗	
科	科	学的科	
可	可	以的可	
渴	渴	望的渴	
克	克	服的克	
刻	刻	刀的刻	
客	客	人的客	
课	课	本的课	
肯	肯	定的肯	
啃	嘴啃	的啃	
垦	垦	荒的垦	
恳	恳	求的恳	
坑	水坑	的坑	
空	空	气的空	
恐	恐	怕的恐	
孔	孔	子的孔	
控	控	制的控	
抠	抠	书的抠	
口	口	头的口	
扣	扣	留的扣	
寇	敌寇	的寇	
枯	枯	木的枯	
哭	哭	笑的哭	
窟	窟	窿的窟	
苦	苦	难的苦	
酷	残酷	的酷	
库	库	房的库	
裤	裤	子的裤	
夸	夸	大的夸	
垮	垮	台的垮	
挎	挎	包的挎	
跨	跨	过的跨	
胯	胯	骨的胯	
块	土块	的块	
筷	筷	子的筷	
侩	市侩	的侩	
快	快	慢的快	
宽	宽	大的宽	
款	款	待的款	
匡	匡	算的匡	
筐	竹筐	的筐	
狂	狂	欢的狂	
框	框	架的框	
矿	矿	石的矿	
眶	眼眶	的眶	
旷	旷	课的旷	
况	况	且的况	
亏	亏	损的亏	
盔	盔	甲的盔	
岿	岿	然的岿	
窥	窥	视的窥	
葵	葵	花的葵	
奎	奎	宁的奎	
魁	魁	鹉的魁	
馈	馈	送的馈	
愧	惭愧	的愧	
溃	崩溃	的溃	
坤	前坤	的坤	
昆	昆	虫的昆	
捆	捆	绑的捆	
困	困	难的困	
扩	扩	大的扩	
廓	轮廓	的廓	
阔	广阔	的阔	
垃	垃	圾的垃	
拉	拉	扯的拉	
喇	喇	马的喇	
蜡	蜡	烛的蜡	
辣	辣	味的辣	
啦	啦	啦	的啦	
莱	莱	菔的莱	
来	来	去的来	
赖	依赖	的赖	
婪	贪婪	的婪	
栏	栏	杆的栏	
拦	阻拦	的拦	
篮	篮	球的篮	
阑	阑	尾的阑	
兰	兰	花的兰	
澜	狂澜	的澜	
谰	谰	言的谰	
揽	包揽	的揽	
览	月览	的览	
懒	懒	惰的懒	
缆	缆	绳的缆	
烂	烂	漫的烂	
滥	泛滥	的滥	
琅	琳琅	的琅	
榔	兵榔	的榔	
狼	狼	犬的狼	
廊	走廊	的廊	
郎	新郎	的郎	
朗	朗	读的朗	
浪	浪	潮的浪	
捞	捞	取的捞	
劳	劳	动的劳	
牢	牢	固的牢	
老	老	年的老	
佬	阔佬	的佬	
姥	姥	姥	的姥	
酪	奶酪	的酪	
烙	烙	铁的烙	
涝	旱涝	的涝	
雷	雷	电的雷	
镭	镭	射的镭	
蕾	蓓蕾	的蕾	
磊	磊	落的磊	
累	积累	的累	
儡	傀儡	的儡	
垒	保垒	的垒	
擂	擂	台的擂	
类	类	型的类	
泪	泪	水的泪	
楞	木楞	的楞	
冷	冷	热的冷	
厘	厘	米的厘	
梨	梨	树的梨	
犁	犁	牛的犁	
黎	黎	明的黎	
篱	篱	笆的篱	
狸	狸	猫的狸	
离	离	开的离	
漓	漓	江的漓	
理	理	论的理	
李	木子的李	
里	里	外的里	
鲤	鲤	鱼的鲤	
礼	礼	品的礼	
莉	茉莉	的莉	
荔	荔	枝的荔	
吏	官吏	的吏	
栗	栗	色的栗	
丽	秀丽	的丽	
厉	厉	害的厉	
励	鼓励	的励	
砾	砾	岩的砾	
历	历	史的历	
利	利	益的利	
傈	僳族的傈	
例	例	如的例	
俐	伶俐	的俐	
痢	痢	疾的痢	
立	起立	的立	
粒	颗粒	的粒	
沥	沥	青的沥	
隶	奴隶	的隶	
力	力	量的力	
璃	玻璃	的璃	
哩	英哩	的哩	
联	联	络的联	
莲	莲	花的莲	
连	连	接的连	
镰	镰	刀的镰	
廉	廉	洁的廉	
怜	可怜	的怜	
涟	涟	漪的涟	
帘	窗帘	的帘	
敛	缩敛	的敛	
脸	脸	盆的脸	
链	链	条的链	
恋	恋	爱的恋	
炼	炼	钢的炼	
练	练	习的练	
粮	粮	食的粮	
凉	凉	快的凉	
梁	性梁	的梁	
粱	高粱	的粱	
良	良	好的良	
两	两	边的两	
辆	车辆	的辆	
量	力量	的量	
晾	晾	晒的晾	
亮	明亮	的亮	
谅	谅	解的谅	
撩	撩	起的撩	
聊	无聊	的聊	
僚	官僚	的僚	
疗	治疗	的疗	
燎	火燎	的燎	
寥	寥	廓的寥	
辽	辽	宁的辽	
撂	撂	挑的撂	
镣	镣	铐的镣	
廖	姓廖	的廖	
料	材料	的料	
列	列	队的列	
裂	分裂	的裂	
烈	烈	火的烈	
劣	优劣	的劣	
猎	打猎	的猎	
琳	琳	琅的琳	
林	林	木的林	
磷	磷	肥的磷	
霖	甘霖	的霖	
临	临	时的临	
邻	邻	居的邻	
鳞	鱼鳞	的鳞	
淋	淋	浴的淋	
凛	凛	冽的凛	
赁	租赁	的赁	
吝	吝	啬的吝	
拎	拎	提的拎	
玲	玲	珑的玲	
菱	菱	角的菱	
零	零	散的零	
龄	年龄	的龄	
铃	铃	当的铃	
伶	伶	仃的伶	
羚	羚	羊的羚	
凌	凌	空的凌	
灵	灵	活的灵	
陵	陵	园的陵	
岭	山岭	的岭	
领	领	导的领	
另	另	外的另	
令	命令	的令	
溜	溜	冰的溜	
琉	琉	璃的琉	
榴	石榴	的榴	
硫	硫	黄的硫	
馏	蒸馏	的馏	
留	停留	的留	
刘	姓刘	的刘	
瘤	瘤	子的瘤	
流	流	动的流	
柳	柳	树的柳	
六	六	个的六	
龙	龙	王的龙	
聋	聋	哑的聋	
咙	喉咙	的咙	
笼	笼	统的笼	
窿	窟窿	的窿	
隆	隆	重的隆	
垄	垄	断的垄	
拢	拉拢	的拢	
陇	陇	海的陇	
楼	楼	梯的楼	
娄	姓娄	的娄	
搂	搂	抱的搂	
篓	竹篓	的篓	
漏	漏	洞的漏	
陋	简陋	的陋	
芦	芦	苇的芦	
卢	卢	布的卢	
颅	头颅	的颅	
庐	茅庐	的庐	
炉	炉	火的炉	
掳	掳	掠的掳	
卤	卤	族的卤	
虏	俘虏	的虏	
鲁	鲁	班的鲁	
麓	山麓	的麓	
路	路	程的路	
赂	贿赂	的赂	
鹿	鹿	茸的鹿	
潞	潞	河的潞	
禄	俸禄	的禄	
录	记录	的录	
戮	杀戮	的戮	
驴	毛驴	的驴	
吕	姓吕	的吕	
铝	金铝	的铝	
侣	伴侣	的侣	
旅	旅	游的旅	
履	履	带的履	
屡	屡	次的屡	
缕	丝缕	的缕	
虑	考虑	的虑	
氯	氯	气的氯	
律	法律	的律	
滤	过滤	的滤	
峦	山峦	的峦	
挛	痉挛	的挛	
孪	孪	生的孪	
滦	滦	河的滦	
卵	卵	子的卵	
乱	混乱	的乱	
掠	掠	夺的掠	
略	略	微的略	
抡	抡	拳的抡	
轮	车轮	的轮	
伦	伦	理的伦	
仑	仑	次的仑	
沦	沦	陷的沦	
论	理论	的论	
萝	萝	卜的萝	
螺	螺	丝的螺	
罗	姓罗	的罗	
逻	逻	辑的逻	
锣	锣	鼓的锣	
箩	箩	筐的箩	
骡	骡	马的骡	
裸	裸	体的裸	
洛	洛	阳的洛	
骆	骆	驼的骆	
妈	妈	妈	的妈	
麻	麻	绳的麻	
玛	玛	瑙的玛	
码	号码	的码	
蚂	蚂	蚁的蚂	
马	牛马	的马	
骂	骂	人的骂	
嘛	做嘛	的嘛	
吗	干吗	的吗	
买	买	卖的买	
麦	小麦	的麦	
卖	买卖	的卖	
迈	迈	进的迈	
瞒	欺瞒	的瞒	
馒	馒	头的馒	
蛮	蛮	横的蛮	
满	满	足的满	
蔓	蔓	延的蔓	
曼	曼	舞的曼	
慢	快慢	的慢	
漫	漫	步的漫	
谩	谩	骂的谩	
芒	芒	果的芒	
茫	茫	然的茫	
盲	盲	目的盲	
氓	流氓	的氓	
忙	忙	碌的忙	
莽	莽	撞的莽	
猫	猫	狗的猫	
茅	茅	草的茅	
锚	抛锚	的锚	
毛	毛	发的毛	
矛	矛	盾的矛	
铆	铆	接的铆	
卯	寅卯	的卯	
茂	茂	密的茂	
冒	冒	险的冒	
帽	帽	子的帽	
貌	礼貌	的貌	
贸	贸	易的贸	
玫	玫	瑰的玫	
枚	枚	举的枚	
梅	梅	花的梅	
酶	酶	原的酶	
霉	霉	雨的霉	
煤	煤	气的煤	
眉	眉	目的眉	
媒	媒	人的媒	
镁	铝镁	的镁	
每	每	天的每	
美	美	丽的美	
昧	昧	心的昧	
寐	梦寐	的寐	
妹	妹	妹	的妹	
媚	媚	外的媚	
门	大门	的门	
闷	闷	气的闷	
们	我们	的们	
萌	萌	发的萌	
蒙	蒙	古的蒙	
檬	柠檬	的檬	
锰	锰	钢的锰	
猛	猛	烈的猛	
梦	梦	想的梦	
孟	姓孟	的孟	
眯	眯	眼的眯	
醚	乙醚	的醚	
靡	风靡	的靡	
糜	糜	烂的糜	
迷	迷	途的迷	
谜	猜谜	的谜	
弥	弥	补的弥	
米	大米	的米	
觅	寻觅	的觅	
蜜	蜜	蜂的蜜	
密	密	码的密	
幂	乘幂	的幂	
棉	棉	花的棉	
眠	安眠	的眠	
绵	绵	软的绵	
冕	加冕	的冕	
免	避免	的免	
勉	勉	励的勉	
娩	分娩	的娩	
缅	缅	甸的缅	
面	表面	的面	
苗	树苗	的苗	
描	描	写的描	
瞄	瞄	准的瞄	
藐	藐	视的藐	
秒	分秒	的秒	
渺	渺	茫的渺	
庙	庙	会的庙	
妙	巧妙	的妙	
蔑	污蔑	的蔑	
灭	灭	火的灭	
民	人民	的民	
抿	抿	嘴的抿	
皿	器皿	的皿	
敏	敏	感的敏	
悯	怜悯	的悯	
闽	闽	江的闽	
明	光明	的明	
螟	螟	虫的螟	
鸣	争鸣	的鸣	
铭	铭	记的铭	
名	姓名	的名	
命	命	令的命	
谬	谬	论的谬	
摸	摸	索的摸	
摹	临摹	的摹	
蘑	蘑	菇的蘑	
膜	耳膜	的膜	
磨	磨	刀的磨	
魔	魔	鬼的魔	
末	末	尾的末	
莫	莫	不的莫	
墨	墨	水的墨	
默	默	写的默	
沫	泡沫	的沫	
漠	沙漠	的漠	
寞	寂寞	的寞	
陌	陌	生的陌	
谋	计谋	的谋	
牟	牟	取的牟	
某	某	人的某	
拇	拇	指的拇	
牡	牡	丹的牡	
亩	地亩	的亩	
姆	保姆	的姆	
母	母	亲的母	
墓	坟墓	的墓	
暮	暮	色的暮	
幕	开幕	的幕	
募	募	捐的募	
慕	羡慕	的慕	
木	木	头的木	
目	目	标的目	
睦	和睦	的睦	
牧	牧	童的牧	
穆	肃穆	的穆	
拿	拿	来的拿	
呐	呐	喊的呐	
钠	钠	盐的钠	
纳	纳	入的纳	
氖	气氖	的氖	
乃	乃	是的乃	
奶	奶	奶	的奶	
耐	耐	心的耐	
奈	奈	何的奈	
南	南	方的南	
男	男	人的男	
难	困难	的难	
囊	囊	括的囊	
挠	挠	痒的挠	
脑	脑	袋的脑	
恼	恼	怒的恼	
闹	热闹	的闹	
淖	泥淖	的淖	
馁	气馁	的馁	
内	内	外的内	
嫩	嫩	叶的嫩	
能	能	够的能	
妮	妮	子的妮	
霓	霓	虹的霓	
倪	端倪	的倪	
泥	泥	土的泥	
尼	尼	姑的尼	
拟	拟	订的拟	
你	你	们的你	
匿	匿	名的匿	
腻	油腻	的腻	
逆	逆	流的逆	
溺	溺	爱的溺	
蔫	打蔫	的蔫	
拈	拈	揪的拈	
年	年	月的年	
碾	碾	盘的碾	
撵	撵	走的撵	
捻	捻	子的捻	
念	想念	的念	
娘	娘	家的娘	
酿	酿	酒的酿	
鸟	鸟	兽的鸟	
捏	捏	造的捏	
聂	聂	耳的聂	
孽	造孽	的孽	
啮	啮	合的啮	
镊	镊	子的镊	
镍	镍	钢的镍	
涅	涅	盘的涅	
您	您	好的您	
柠	柠	檬的柠	
狞	狰狞	的狞	
凝	凝	结的凝	
宁	宁	静的宁	
拧	拧	甘的拧	
泞	泥泞	的泞	
牛	牛	奶的牛	
扭	扭	力的扭	
钮	钮	扣的钮	
纽	纽	带的纽	
脓	脓	包的脓	
浓	浓	度的浓	
农	农	民的农	
奴	奴	隶的奴	
努	努	力的努	
怒	怒	火的怒	
女	女	人的女	
暖	温暖	的暖	
虐	虐	待的虐	
挪	挪	动的挪	
懦	懦	弱的懦	
糯	糯	米的糯	
诺	诺	言的诺	
欧	欧	洲的欧	
鸥	海鸥	的鸥	
殴	殴	打的殴	
藕	莲藕	的藕	
呕	呕	吐的呕	
偶	偶	然的偶	
沤	沤	肥的沤	
啪	啪	哒的啪	
趴	趴	伏的趴	
爬	爬	行的爬	
帕	手帕	的帕	
怕	害怕	的怕	
琶	琵琶	的琶	
拍	拍	手的拍	
排	排	对的排	
牌	门牌	的牌	
徘	徘	徊的徘	
湃	澎湃	的湃	
派	派	别的派	
攀	攀	登的攀	
潘	姓潘	的潘	
盘	盘	算的盘	
磐	磐	石的磐	
盼	盼	望的盼	
畔	湖畔	的畔	
判	判	断的判	
叛	叛	变的叛	
乓	乒乓	的乓	
庞	庞	大的庞	
旁	旁	边的旁	
耪	耪	地的耪	
胖	胖	子的胖	
抛	抛	弃的抛	
咆	咆	哮的咆	
袍	皮袍	的袍	
跑	跑	步的跑	
泡	泡	沫的泡	
呸	呸	呸	的呸	
胚	胚	胎的胚	
培	培	养的培	
裴	姓裴	的裴	
赔	赔	礼的赔	
陪	陪	伴的陪	
配	配	合的配	
佩	佩	服的佩	
沛	充沛	的沛	
喷	喷	泉的喷	
盆	脸盆	的盆	
砰	砰	砰	的砰	
抨	抨	击的抨	
烹	烹	饪的烹	
澎	澎	湃的澎	
彭	姓彭	的彭	
蓬	蓬	莱的蓬	
棚	木棚	的棚	
硼	硼	酸的硼	
篷	大篷	的篷	
膨	膨	胀的膨	
朋	朋	友的朋	
鹏	鲲鹏	的鹏	
捧	捧	场的捧	
碰	碰	壁的碰	
坯	土砖的坯	
砒	砒	霜的砒	
霹	霹	雳的霹	
批	批	评的批	
披	披	挂的披	
劈	劈	山的劈	
琵	琵	琶的琵	
毗	毗	邻的毗	
啤	啤	酒的啤	
脾	脾	气的脾	
疲	疲	倦的疲	
皮	肉皮	的皮	
匹	布匹	的匹	
痞	痞	子的痞	
僻	僻	静的僻	
屁	放屁	的屁	
譬	譬	如的譬	
篇	篇	幅的篇	
偏	偏	差的偏	
片	片	面的片	
骗	欺骗	的骗	
飘	飘	带的飘	
漂	漂	浮的漂	
瓢	瓜瓢	的瓢	
票	票	据的票	
撇	撇	开的撇	
瞥	瞥	见的瞥	
拼	拼	音的拼	
频	频	繁的频	
贫	贫	困的贫	
品	品	牌的品	
聘	聘	请的聘	
乒	乒	乓的乒	
坪	草坪	的坪	
苹	苹	果的苹	
萍	浮萍	的萍	
平	平	面的平	
凭	凭	借的凭	
瓶	瓶	子的瓶	
评	评	论的评	
坡	坡	度的坡	
泼	泼	水的泼	
颇	颇	为的颇	
婆	婆	婆	的婆	
破	破	旧的破	
粕	糟粕	的粕	
剖	剖	面的剖	
扑	扑	打的扑	
铺	铺	盖的铺	
仆	仆	人的仆	
莆	莆	田的莆	
葡	葡	萄的葡	
菩	菩	萨的菩	
蒲	蒲	草的蒲	
圃	苗圃	的圃	
普	普	通的普	
浦	浦	口的浦	
谱	曲谱	的谱	
期	日期	的期	
欺	欺	骗的欺	
栖	栖	身的栖	
戚	亲戚	的戚	
妻	妻	子的妻	
七	七	个的七	
凄	凄	惨的凄	
漆	油漆	的漆	
柒	大写的柒	
沏	沏	茶的沏	
其	其	它的其	
棋	围棋	的棋	
歧	分歧	的歧	
畦	畦	田的畦	
崎	崎	岖的崎	
脐	肚脐	的脐	
齐	齐	整的齐	
旗	红旗	的旗	
祈	祈	祷的祈	
祁	祁	养的祁	
骑	骑	马的骑	
起	起	来的起	
岂	岂	能的岂	
乞	乞	求的乞	
企	企	图的企	
启	启	发的启	
契	契	约的契	
砌	砌	砖的砌	
器	器	具的器	
气	空气	的气	
迄	迄	今的迄	
弃	抛弃	的弃	
汽	汽	水的汽	
泣	哭泣	的泣	
讫	收讫	的讫	
掐	掐	头的掐	
恰	恰	好的恰	
洽	接洽	的洽	
牵	牵	连的牵	
扦	扦	插的扦	
钎	钢钎	的钎	
铅	铅	心的铅	
千	千	万的千	
迁	迁	移的迁	
签	签	名的签	
仟	大写的仟	
谦	谦	让的谦	
黔	黔	首的黔	
钱	钱	币的钱	
钳	虎钳	的钳	
前	前	后的前	
潜	潜	伏的潜	
遣	派遣	的遣	
浅	浅	勃的浅	
谴	谴	责的谴	
堑	堑	壕的堑	
嵌	镶欠的嵌	
欠	欠	债的欠	
歉	道歉	的歉	
枪	枪	炮的枪	
呛	口呛	的呛	
腔	马腔	的腔	
羌	羌	族的羌	
墙	墙	壁的墙	
蔷	蔷	薇的蔷	
抢	抢	夺的抢	
橇	雪橇	的橇	
锹	铁锹	的锹	
敲	敲	打的敲	
悄	悄	然的悄	
桥	桥	梁的桥	
瞧	瞧	看的瞧	
乔	乔	迁的乔	
侨	华侨	的侨	
巧	巧	合的巧	
撬	撬	锁的撬	
翘	翘	尾的翘	
峭	峭	壁的峭	
俏	俏	皮的俏	
窍	窍	门的窍	
切	切	断的切	
且	并且	的且	
怯	胆怯	的怯	
窃	偷窃	的窃	
钦	钦	佩的钦	
侵	侵	略的侵	
亲	亲	切的亲	
秦	秦	皇的秦	
琴	钢琴	的琴	
勤	勤	奋的勤	
芹	芹	菜的芹	
擒	擒	拿的擒	
禽	家禽	的禽	
寝	寝	室的寝	
沁	沁	人的沁	
青	青	草的青	
轻	轻	易的轻	
氢	氢	气的氢	
倾	倾	盆的倾	
卿	爱卿	的卿	
清	清	水的清	
擎	擎	举的擎	
晴	晴	日的晴	
氰	氰	化的氰	
情	情	况的情	
顷	顷	刻的顷	
请	请	问的请	
庆	庆	祝的庆	
琼	琼	嵝的琼	
穷	穷	苦的穷	
秋	秋	天的秋	
丘	丘	岭的丘	
邱	姓邱	的邱	
球	球	网的球	
求	要求	的求	
囚	囚	犯的囚	
酋	酋	掌的酋	
泅	泅	渡的泅	
趋	趋	向的趋	
蛆	蛆	虫的蛆	
曲	姓曲	的曲	
躯	躯	体的躯	
屈	屈	服的屈	
驱	驱	逐的驱	
渠	沟渠	的渠	
取	取	得的取	
娶	娶	亲的娶	
龋	龋	齿的龋	
趣	趣	味的趣	
去	来去	的去	
颧	颧	骨的颧	
权	权	利的权	
醛	甲醛	的醛	
泉	泉	水的泉	
全	全	面的全	
痊	痊	愈的痊	
拳	拳	头的拳	
犬	犬	牙的犬	
券	证券	的券	
劝	劝	告的劝	
缺	缺	点的缺	
瘸	瘸	子的瘸	
却	退却	的却	
鹊	喜鹊	的鹊	
榷	商榷	的榷	
确	确	定的确	
裙	裙	子的裙	
群	群	众的群	
然	然	而的然	
燃	燃	料的燃	
冉	冉	冉	的冉	
染	染	色的染	
瓤	瓜瓤	的瓤	
壤	土壤	的壤	
攘	攘	外的攘	
嚷	嚷	嚷	的嚷	
让	让	步的让	
饶	饶	恕的饶	
扰	扰	乱的扰	
绕	绕	弯的绕	
惹	惹	祸的惹	
热	热	烈的热	
壬	姓壬	的壬	
仁	仁	义的仁	
人	人	民的人	
忍	忍	耐的忍	
韧	坚韧	的韧	
任	任	何的任	
认	认	为的认	
刃	刀刃	的刃	
妊	妊	娠的妊	
纫	缝纫	的纫	
扔	扔	球的扔	
仍	仍	然的仍	
日	日	月的日	
戎	戎	马的戎	
茸	鹿茸	的茸	
蓉	芙蓉	的蓉	
荣	光荣	的荣	
融	融	洽的融	
熔	熔	化的熔	
溶	溶	解的溶	
容	容	易的容	
绒	绒	线的绒	
冗	冗	余的冗	
揉	揉	搓的揉	
柔	柔	软的柔	
肉	肉	皮的肉	
茹	茹	苦的茹	
蠕	蠕	动的蠕	
儒	儒	家的儒	
孺	孺	子的孺	
如	如	果的如	
辱	辱	骂的辱	
乳	乳	房的乳	
汝	汝	辈的汝	
入	入	口的入	
褥	褥	子的褥	
软	软	硬的软	
阮	姓阮	的阮	
蕊	花蕊	的蕊	
瑞	瑞	雪的瑞	
锐	锐	利的锐	
闰	闰	年的闰	
润	润	滑的润	
若	若	是的若	
弱	弱	小的弱	
撒	撒	播的撒	
洒	洒	水的洒	
萨	菩萨	的萨	
腮	腮	帮的腮	
鳃	鱼鳃	的鳃	
赛	赛	跑的赛	
三	三	个的三	
叁	大写的叁	
伞	雨伞	的伞	
散	散	步的散	
桑	桑	蚕的桑	
嗓	嗓	子的嗓	
丧	丧	失的丧	
搔	搔	头的搔	
骚	骚	乱的骚	
扫	扫	地的扫	
嫂	嫂	子的嫂	
瑟	琴瑟	的瑟	
涩	涩	味的涩	
森	森	林的森	
僧	僧	侣的僧	
砂	砂	子的砂	
杀	杀	人的杀	
沙	沙	漠的沙	
纱	纺纱	的纱	
傻	傻	瓜的傻	
啥	有啥	的啥	
煞	煞	气的煞	
筛	筛	选的筛	
晒	晾晒	的晒	
珊	珊	瑚的珊	
苫	苫	布的苫	
山	山	水的山	
删	删	除的删	
煽	煽	惑的煽	
衫	衣衫	的衫	
闪	闪	电的闪	
陕	陕	西的陕	
擅	擅	自的擅	
赡	赡	养的赡	
膳	膳	宿的膳	
善	善	良的善	
汕	汕	头的汕	
扇	扇	风的扇	
缮	修缮	的缮	
墒	保墒	的墒	
伤	伤	口的伤	
商	商	品的商	
赏	赏	罚的赏	
晌	晌	午的晌	
上	上	面的上	
尚	尚	且的尚	
捎	捎	带的捎	
稍	稍	微的稍	
烧	烧	火的烧	
芍	芍	药的芍	
勺	铁勺	的勺	
韶	韶	山的韶	
少	多少	的少	
哨	口哨	的哨	
邵	姓邵	的邵	
绍	介绍	的绍	
奢	奢	侈的奢	
赊	赊	帐的赊	
蛇	毒蛇	的蛇	
舌	舌	头的舌	
舍	宿舍	的舍	
赦	大赦	的赦	
摄	摄	影的摄	
射	射	击的射	
慑	危慑	的慑	
涉	杆涉	的涉	
社	社	会的社	
设	设	计的设	
砷	砷	物的砷	
申	申	报的申	
呻	呻	吟的呻	
伸	伸	展的伸	
身	身	体的身	
深	深	浅的深	
娠	妊娠	的娠	
绅	绅	士的绅	
神	神	仙的神	
审	审	批的审	
婶	婶	娘的婶	
甚	甚	好的甚	
肾	肾	脏的肾	
慎	谨慎	的慎	
渗	渗	透的渗	
声	声	音的声	
生	生	活的生	
甥	外甥	的甥	
牲	牲	口的牲	
升	升	高的升	
绳	草绳	的绳	
剩	剩	下的剩	
胜	胜	利的胜	
圣	圣	人的圣	
师	老师	的师	
失	失	误的失	
狮	狮	虎的狮	
施	施	工的施	
湿	杆湿	的湿	
诗	诗	篇的诗	
尸	尸	体的尸	
虱	昆虫的虱	
十	十	个的十	
拾	大写的拾	
时	时	间的时	
蚀	腐蚀	的蚀	
实	实	在的实	
识	认识	的识	
史	历史	的史	
矢	矢	量的矢	
使	使	用的使	
屎	屎	粪的屎	
驶	驾驶	的驶	
始	开始	的始	
式	形式	的式	
示	表示	的示	
士	士	兵的士	
世	世	纪的世	
柿	柿	子的柿	
事	事	情的事	
拭	拭	目的拭	
誓	誓	言的誓	
逝	逝	世的逝	
势	势	力的势	
是	是	否的是	
嗜	嗜	号的嗜	
噬	吞噬	的噬	
适	适	当的适	
仕	仕	女的仕	
侍	侍	从的侍	
释	释	放的释	
饰	装饰	的饰	
氏	姓氏	的氏	
市	市	场的市	
恃	依恃	的恃	
室	教室	的室	
视	重视	的视	
试	考试	的试	
收	收	发的收	
手	手	脚的手	
首	首	脑的首	
守	守	卫的守	
寿	寿	命的寿	
授	授	课的授	
售	售	货的售	
受	受	到的受	
瘦	胖瘦	的瘦	
兽	野兽	的兽	
蔬	蔬	菜的蔬	
枢	枢	纽的枢	
梳	梳	头的梳	
殊	特殊	的殊	
抒	抒	情的抒	
输	输	出的输	
叔	叔	叔	的叔	
舒	舒	服的舒	
淑	淑	女的淑	
疏	疏	导的疏	
书	书	本的书	
赎	赎	买的赎	
孰	孰	可的孰	
熟	熟	人的熟	
薯	白薯	的薯	
暑	暑	期的暑	
曙	曙	光的曙	
署	署	名的署	
蜀	蜀	汉的蜀	
黍	黍	子的黍	
鼠	老鼠	的鼠	
属	属	于的属	
述	叙述	的述	
树	树	木的树	
束	约束	的束	
戍	卫戍	的戍	
竖	竖	立的竖	
墅	别墅	的墅	
庶	庶	民的庶	
漱	漱	口的漱	
恕	宽恕	的恕	
刷	刷	子的刷	
耍	玩耍	的耍	
摔	摔	交的摔	
甩	甩	掉的甩	
帅	元帅	的帅	
栓	枪栓	的栓	
拴	拴	马的拴	
霜	霜	雪的霜	
双	单双	的双	
爽	爽	快的爽	
水	水	火的水	
睡	睡	叫的睡	
税	税	款的税	
吮	吮	吸的吮	
瞬	瞬	间的瞬	
顺	顺	利的顺	
舜	尧舜	的舜	
硕	硕	士的硕	
朔	朔	望的朔	
烁	闪烁	的烁	
斯	斯	文的斯	
撕	撕	破的撕	
嘶	嘶	哑的嘶	
思	思	想的思	
私	私	人的私	
司	公司	的司	
丝	丝	绸的丝	
死	死	去的死	
肆	放肆	的肆	
寺	寺	院的寺	
嗣	嗣	后的嗣	
四	四	个的四	
饲	饲	料的饲	
巳	巳	时的巳	
松	松	木的松	
耸	耸	动的耸	
怂	怂	恿的怂	
颂	颂	歌的颂	
送	送	别的送	
宋	性宋	的宋	
讼	诉讼	的讼	
诵	朗诵	的诵	
搜	搜	索的搜	
艘	一艘	的艘	
擞	抖擞	的擞	
嗽	咳嗽	的嗽	
苏	江苏	的苏	
酥	酥	糖的酥	
俗	风俗	的俗	
素	素	朴的素	
速	速	度的速	
粟	粟	米的粟	
僳	速傈的僳	
塑	塑	料的塑	
溯	溯	流的溯	
诉	告诉	的诉	
肃	严肃	的肃	
酸	酸	碱的酸	
蒜	大蒜	的蒜	
算	算	术的算	
虽	虽	然的虽	
隋	隋	朝的隋	
随	随	便的随	
绥	绥	靖的绥	
髓	骨髓	的髓	
碎	破碎	的碎	
岁	年岁	的岁	
穗	麦穗	的穗	
遂	遂	愿的遂	
隧	隧	道的隧	
祟	作祟	的祟	
孙	孙	子的孙	
损	损	失的损	
笋	竹笋	的笋	
蓑	蓑	衣的蓑	
梭	梭	子的梭	
唆	叫唆	的唆	
琐	琐	碎的琐	
索	索	取的索	
锁	锁	链的锁	
所	所	以的所	
塌	塌	方的塌	
他	男他	的他	
它	其它	的它	
她	女她	的她	
塔	宝塔	的塔	
獭	水獭	的獭	
挞	挞	伐的挞	
蹋	糟蹋	的蹋	
踏	脚踏	的踏	
胎	胚胎	的胎	
苔	苔	藓的苔	
抬	抬	高的抬	
台	台	湾的台	
泰	泰	山的泰	
酞	酚酞	的酞	
太	太	阳的太	
态	态	度的态	
汰	淘汰	的汰	
坍	坍	塌的坍	
摊	摊	派的摊	
贪	贪	污的贪	
瘫	瘫	痪的瘫	
滩	沙滩	的滩	
坛	天坛	的坛	
檀	檀	香的檀	
痰	痰	盂的痰	
潭	龙潭	的潭	
谭	姓谭	的谭	
谈	谈	话的谈	
坦	坦	白的坦	
毯	毛毯	的毯	
袒	袒	露的袒	
碳	碳	酸的碳	
探	探	测的探	
叹	叹	气的叹	
炭	炭	火的炭	
汤	汤	药的汤	
塘	钱塘	的塘	
搪	搪	瓷的搪	
堂	课堂	的堂	
棠	海棠	的棠	
膛	胸膛	的膛	
唐	唐	朝的唐	
糖	糖	果的糖	
躺	躺	倒的躺	
淌	淌	汗的淌	
趟	走趟	的趟	
烫	烫	手的烫	
掏	掏	洞的掏	
涛	波涛	的涛	
滔	滔	天的滔	
绦	绦	虫的绦	
萄	葡萄	的萄	
桃	桃	圆的桃	
逃	逃	走的逃	
淘	淘	金的淘	
陶	陶	瓷的陶	
讨	讨	论的讨	
套	外套	的套	
特	特	别的特	
藤	藤	条的藤	
腾	奔腾	的腾	
疼	疼	痛的疼	
誊	誊	写的誊	
梯	楼梯	的梯	
剔	挑剔	的剔	
踢	踢	球的踢	
锑	金锑	的锑	
题	题	目的题	
蹄	马蹄	的蹄	
啼	啼	哭的啼	
体	体	育的体	
替	替	换的替	
嚏	嚏	喷的嚏	
惕	警惕	的惕	
涕	鼻涕	的涕	
剃	剃	刀的剃	
屉	抽屉	的屉	
天	天	地的天	
添	添	置的添	
填	填	空的填	
田	田	地的田	
甜	甜	蜜的甜	
恬	恬	静的恬	
舔	舔	舌的舔	
腆	腼腆	的腆	
挑	挑	选的挑	
条	条	件的条	
迢	迢	迢	的迢	
眺	眺	望的眺	
跳	跳	高的跳	
贴	贴	补的贴	
铁	铁	丝的铁	
帖	请帖	的帖	
厅	大厅	的厅	
听	听	见的听	
烃	烃	基的烃	
汀	水汀	的汀	
廷	宫廷	的廷	
停	停	止的停	
亭	亭	子的亭	
庭	庭	院的庭	
挺	挺	胸的挺	
艇	潜艇	的艇	
通	通	过的通	
桐	梧桐	的桐	
酮	丙酮	的酮	
瞳	瞳	孔的瞳	
同	同	志的同	
铜	铜	铁的铜	
彤	红彤	的彤	
童	童	年的童	
桶	木桶	的桶	
捅	捅	漏的捅	
筒	竹筒	的筒	
统	统	一的统	
痛	痛	苦的痛	
偷	偷	窃的偷	
投	投	奔的投	
头	头	脑的头	
透	透	明的透	
凸	凸	出的凸	
秃	秃	头的秃	
突	突	然的突	
图	图	书的图	
徒	徒	步的徒	
途	路途	的途	
涂	涂	改的涂	
屠	屠	夫的屠	
土	土	地的土	
吐	吐	沫的吐	
兔	兔	子的兔	
湍	湍	急的湍	
团	团	结的团	
推	推	动的推	
颓	颓	废的颓	
腿	腿	脚的腿	
蜕	蜕	变的蜕	
退	退	却的退	
吞	吞	并的吞	
屯	屯	垦的屯	
臀	臀	部的臀	
拖	拖	拉的拖	
托	委托	的托	
脱	脱	离的脱	
鸵	鸵	鸟的鸵	
陀	陀	螺的陀	
驼	驼	背的驼	
椭	椭	圆的椭	
妥	妥	当的妥	
唾	唾	弃的唾	
挖	挖	土的挖	
哇	哇	啦的哇	
蛙	青蛙	的蛙	
洼	洼	地的洼	
娃	娃	娃	的娃	
瓦	砖瓦	的瓦	
袜	鞋袜	的袜	
歪	歪	曲的歪	
外	里外	的外	
豌	豌	豆的豌	
弯	弯	曲的弯	
湾	海湾	的湾	
玩	玩	具的玩	
顽	顽	皮的顽	
丸	丸	药的丸	
烷	甲烷	的烷	
完	完	毕的完	
碗	饭碗	的碗	
挽	挽	回的挽	
晚	晚	上的晚	
皖	皖	南的皖	
惋	惋	惜的惋	
宛	宛	如的宛	
婉	婉	转的婉	
万	千万	的万	
腕	手腕	的腕	
汪	水汪	的汪	
王	王	子的王	
亡	死亡	的亡	
枉	冤枉	的枉	
网	网	兜的网	
往	往	返的往	
旺	兴旺	的旺	
望	盼望	的望	
忘	忘	记的忘	
妄	妄	图的妄	
威	威	信的威	
巍	巍	峨的巍	
微	微	弱的微	
危	危	险的危	
韦	皮韦	的韦	
违	违	反的违	
桅	桅	杆的桅	
围	围	攻的围	
唯	唯	物的唯	
惟	惟	恐的惟	
为	为	何的为	
潍	潍	坊的潍	
维	维	护的维	
苇	芦苇	的苇	
萎	萎	缩的萎	
委	委	派的委	
伟	伟	大的伟	
伪	伪	装的伪	
纬	经纬	的纬	
未	未	来的未	
味	口味	的味	
畏	畏	惧的畏	
胃	胃	肠的胃	
喂	喂	养的喂	
魏	魏	碑的魏	
位	位	子的位	
渭	渭	河的渭	
谓	称谓	的谓	
尉	尉	官的尉	
慰	慰	问的慰	
卫	卫	生的卫	
瘟	瘟	病的瘟	
温	温	和的温	
蚊	蚊	虫的蚊	
文	文	化的文	
闻	新闻	的闻	
纹	纹	理的纹	
吻	结吻	的吻	
稳	稳	定的稳	
紊	紊	乱的紊	
问	问	题的问	
嗡	嗡	嗡	的嗡	
翁	渔翁	的翁	
瓮	瓮	中的瓮	
挝	老挝	的挝	
蜗	蜗	牛的蜗	
窝	窝	藏的窝	
我	我	们的我	
斡	斡	旋的斡	
卧	卧	铺的卧	
握	握	手的握	
沃	沃	土的沃	
巫	巫	婆的巫	
呜	呜	咽的呜	
钨	钨	钢的钨	
乌	乌	鸦的乌	
污	污	水的污	
诬	诬	蔑的诬	
屋	房屋	的屋	
无	无	法的无	
芜	荒芜	的芜	
梧	梧	桐的梧	
吾	吾	辈的吾	
吴	吴	国的吴	
毋	毋	宁的毋	
武	武	器的武	
五	五	个的五	
捂	捂	盖的捂	
午	中午	的午	
舞	跳舞	的舞	
伍	队伍	的伍	
侮	侮	辱的侮	
坞	船坞	的坞	
戊	戊	时的戊	
雾	云雾	的雾	
晤	会晤	的晤	
物	物	品的物	
勿	勿	论的勿	
务	务	必的务	
悟	觉悟	的悟	
误	错误	的误	
昔	昔	日的昔	
熙	康熙	的熙	
析	分析	的析	
西	西	方的西	
硒	硒	素的硒	
矽	矽	钢的矽	
晰	清晰	的晰	
嘻	嘻	哈的嘻	
吸	呼吸	的吸	
锡	锡	金的锡	
牺	牺	牲的牺	
稀	稀	博的稀	
息	休息	的息	
希	希	望的希	
悉	获悉	的悉	
膝	膝	盖的膝	
夕	夕	阳的夕	
惜	可惜	的惜	
熄	熄	灭的熄	
烯	丙烯	的烯	
溪	溪	水的溪	
汐	潮汐	的汐	
犀	犀	牛的犀	
檄	檄	文的檄	
袭	袭	击的袭	
席	席	子的席	
习	练习	的习	
媳	婆媳	的媳	
喜	喜	欢的喜	
系	系	统的系	
隙	缝隙	的隙	
细	细	胞的细	
瞎	瞎	眼的瞎	
匣	匣	子的匣	
霞	彩霞	的霞	
辖	管辖	的辖	
暇	闲暇	的暇	
峡	三峡	的峡	
侠	侠	客的侠	
狭	狭	隘的狭	
下	下	面的下	
夏	夏	天的夏	
掀	掀	开的掀	
锨	铁锨	的锨	
先	先	后的先	
仙	仙	人的仙	
鲜	新鲜	的鲜	
咸	咸	盐的咸	
贤	贤	惠的贤	
衔	衔	接的衔	
舷	舷	梯的舷	
闲	闲	空的闲	
涎	涎	水的涎	
弦	琴弦	的弦	
嫌	嫌	疑的嫌	
显	明显	的显	
险	危险	的险	
现	现	在的现	
献	贡献	的献	
县	县	城的县	
腺	汗腺	的腺	
馅	肉馅	的馅	
羡	羡	慕的羡	
宪	宪	法的宪	
陷	轮陷	的陷	
限	限	度的限	
线	线	路的线	
相	相	互的相	
厢	厢	房的厢	
镶	镶	嵌的镶	
香	香	味的香	
箱	箱	子的箱	
襄	襄	阳的襄	
湘	湘	绣的湘	
乡	乡	村的乡	
翔	飞翔	的翔	
祥	慈祥	的祥	
详	详	细的详	
想	想	念的想	
响	影响	的响	
享	享	受的享	
项	项	目的项	
橡	橡	胶的橡	
像	像	片的像	
向	向	前的向	
象	大象	的象	
萧	萧	条的萧	
硝	硝	酸的硝	
霄	霄	汉的霄	
哮	咆哮	的哮	
嚣	嚣	张的嚣	
销	销	售的销	
消	消	灭的消	
宵	良宵	的宵	
淆	混淆	的淆	
晓	拂晓	的晓	
小	大小	的小	
孝	孝	敬的孝	
肖	姓肖	的肖	
啸	常啸	的啸	
笑	笑	容的笑	
效	效	果的效	
楔	木楔	的楔	
些	一些	的些	
歇	歇	脚的歇	
蝎	蝎	子的蝎	
鞋	鞋	袜的鞋	
协	协	力的协	
携	携	带的携	
邪	邪	恶的邪	
斜	斜	坡的斜	
胁	胁	从的胁	
谐	谐	和的谐	
写	写	字的写	
械	机械	的械	
卸	推卸	的卸	
蟹	螃蟹	的蟹	
懈	松懈	的懈	
泄	泄	气的泄	
泻	腹泻	的泻	
谢	感谢	的谢	
屑	不屑	的屑	
薪	薪	金的薪	
芯	灯芯	的芯	
锌	锌	版的锌	
欣	欣	赏的欣	
辛	辛	苦的辛	
新	新	旧的新	
忻	姓忻	的忻	
心	心	里的心	
信	信	息的信	
衅	挑衅	的衅	
星	星	光的星	
腥	腥	臭的腥	
猩	猩	猩	的猩	
惺	惺	忪的惺	
兴	兴	旺的兴	
刑	判刑	的刑	
型	型	号的型	
形	形	状的形	
邢	姓邢	的邢	
醒	睡醒	的醒	
幸	幸	福的幸	
杏	杏	仁的杏	
性	性	别的性	
姓	姓	名的姓	
兄	兄	弟的兄	
凶	凶	恶的凶	
胸	胸	膛的胸	
匈	匈	奴的匈	
汹	汹	涌的汹	
雄	雄	伟的雄	
熊	熊	猫的熊	
休	休	息的休	
修	修	理的修	
羞	羞	愧的羞	
朽	不朽	的朽	
嗅	嗅	觉的嗅	
锈	铁锈	的锈	
秀	秀	丽的秀	
袖	袖	子的袖	
绣	绣	花的绣	
墟	废墟	的墟	
戌	物戌	的戌	
需	需	要的需	
虚	虚	伪的虚	
须	必须	的须	
徐	姓徐	的徐	
许	许	多的许	
蓄	积蓄	的蓄	
酗	酗	酒的酗	
叙	叙	述的叙	
旭	旭	日的旭	
序	次序	的序	
恤	抚恤	的恤	
絮	花絮	的絮	
婿	女婿	的婿	
绪	头绪	的绪	
续	继续	的续	
轩	轩	然的轩	
喧	喧	闹的喧	
宣	宣	传的宣	
悬	悬	挂的悬	
旋	旋	转的旋	
玄	玄	虚的玄	
选	选	举的选	
癣	脚癣	的癣	
眩	眩	晕的眩	
绚	绚	丽的绚	
靴	靴	子的靴	
薛	姓薛	的薛	
学	学	校的学	
穴	穴	位的穴	
雪	雨雪	的雪	
勋	功勋	的勋	
熏	熏	陶的熏	
循	循	环的循	
旬	旬	日的旬	
询	询	问的询	
驯	驯	马的驯	
巡	巡	逻的巡	
殉	殉	难的殉	
汛	防汛	的汛	
训	训	练的训	
讯	音讯	的讯	
逊	逊	色的逊	
迅	迅	速的迅	
压	压	迫的压	
押	押	解的押	
鸦	乌鸦	的鸦	
鸭	鸭	蛋的鸭	
呀	啊呀	的呀	
丫	丫	鬟的丫	
芽	发芽	的芽	
牙	牙	齿的牙	
蚜	蚜	虫的蚜	
崖	山崖	的崖	
衙	衙	门的衙	
涯	天涯	的涯	
雅	雅	观的雅	
哑	哑	巴的哑	
亚	亚	洲的亚	
讶	惊讶	的讶	
焉	焉	能的焉	
阉	阉	割的阉	
淹	淹	没的淹	
盐	盐	巴的盐	
严	严	格的严	
研	研	究的研	
蜒	油蜒	的蜒	
岩	岩	石的岩	
延	延	长的延	
言	言	谈的言	
颜	颜	色的颜	
阎	阎	王的阎	
炎	炎	热的炎	
沿	沿	线的沿	
奄	奄	忽的奄	
掩	掩	盖的掩	
眼	眼	睛的眼	
衍	敷衍	的衍	
演	表演	的演	
艳	鲜艳	的艳	
堰	堤堰	的堰	
燕	燕	子的燕	
厌	厌	恶的厌	
砚	砚	台的砚	
雁	鸿雁	的雁	
唁	吊唁	的唁	
彦	彦	胜的彦	
焰	火焰	的焰	
宴	宴	请的宴	
谚	谚	语的谚	
验	考验	的验	
殃	遭殃	的殃	
央	中央	的央	
鸯	鸳鸯	的鸯	
秧	秧	苗的秧	
杨	杨	柳的杨	
扬	飞扬	的扬	
佯	佯	攻的佯	
疡	溃疡	的疡	
羊	牛羊	的羊	
洋	海洋	的洋	
阳	太阳	的阳	
氧	氧	气的氧	
仰	仰	望的仰	
痒	搔痒	的痒	
养	培养	的养	
样	样	品的样	
漾	荡漾	的漾	
邀	邀	请的邀	
腰	腰	包的腰	
妖	妖	怪的妖	
瑶	瑶	池的瑶	
摇	动摇	的摇	
尧	尧	舜的尧	
遥	遥	控的遥	
窑	窑	洞的窑	
谣	谣	言的谣	
姚	姓姚	的姚	
咬	咬	人的咬	
舀	舀	水的舀	
药	药	品的药	
要	邀求的要	
耀	照耀	的耀	
椰	椰	子的椰	
噎	打噎	的噎	
耶	耶	稣的耶	
爷	爷	爷	的爷	
野	荒野	的野	
冶	冶	金的冶	
也	也	许的也	
页	页	面的页	
掖	掖	近的掖	
业	工业	的业	
叶	树叶	的叶	
曳	拖曳	的曳	
腋	腋	下的腋	
夜	夜	晚的夜	
液	液	体的液	
一	一	个的一	
壹	大写的壹	
医	医	学的医	
揖	作揖	的揖	
铱	铱	金的铱	
依	依	然的依	
伊	伊	人的伊	
衣	衣	服的衣	
颐	颐	和的颐	
夷	蛮夷	的夷	
遗	遗	忘的遗	
移	移	动的移	
仪	仪	器的仪	
胰	胰	脏的胰	
疑	疑	心的疑	
沂	沂	水的沂	
宜	适宜	的宜	
姨	阿姨	的姨	
彝	彝	族的彝	
椅	桌椅	的椅	
蚁	蚂蚁	的蚁	
倚	倚	仗的倚	
已	已	经的已	
乙	甲乙	的乙	
矣	甚矣	的矣	
以	所以	的以	
艺	艺	术的艺	
抑	抑	扬的抑	
易	容易	的易	
邑	城邑	的邑	
亿	亿	万的亿	
役	服役	的役	
臆	臆	测的臆	
逸	陶逸	的逸	
肄	肄	业的肄	
疫	防疫	的疫	
亦	亦	可的亦	
裔	后裔	的裔	
意	意	义的意	
毅	刚毅	的毅	
忆	回忆	的忆	
义	主义	的义	
益	利益	的益	
溢	溢	出的溢	
诣	造诣	的诣	
议	议	会的议	
谊	友谊	的谊	
译	翻译	的译	
异	异	常的异	
翼	侧翼	的翼	
翌	翌	日的翌	
绎	演绎	的绎	
茵	草茵	的茵	
荫	荫	凉的荫	
因	因	为的因	
殷	殷	勤的殷	
音	音	月的音	
阴	阴	天的阴	
姻	婚姻	的姻	
吟	呻吟	的吟	
银	金银	的银	
淫	淫	乱的淫	
寅	寅	卯的寅	
饮	饮	料的饮	
尹	府尹	的尹	
引	引	导的引	
隐	隐	蔽的隐	
印	印	象的印	
英	英	雄的英	
樱	樱	桃的樱	
婴	婴	儿的婴	
鹰	老鹰	的鹰	
应	应	该的应	
缨	红缨	的缨	
莹	晶莹	的莹	
萤	萤	火的萤	
营	营	掌的营	
荧	荧	光的荧	
蝇	苍蝇	的蝇	
迎	迎	接的迎	
赢	赢	利的赢	
盈	盈	余的盈	
影	电影	的影	
颖	颖	悟的颖	
硬	硬	壳的硬	
映	反映	的映	
哟	助词的哟	
拥	拥	护的拥	
佣	佣	人的佣	
臃	臃	肿的臃	
痈	痈	疽的痈	
庸	庸	俗的庸	
雍	雍	正的雍	
踊	踊	跃的踊	
蛹	虫蛹	的蛹	
咏	咏	叹的咏	
泳	游泳	的泳	
涌	涌	现的涌	
永	永	久的永	
恿	怂恿	的恿	
勇	勇	敢的勇	
用	用	途的用	
幽	幽	默的幽	
优	优	点的优	
悠	悠	久的悠	
忧	忧	虑的忧	
尤	尤	其的尤	
由	由	于的由	
邮	邮	票的邮	
铀	铀	矿的铀	
犹	犹	如的犹	
油	油	田的油	
游	游	览的游	
酉	酉	时的酉	
有	没有	的有	
友	友	好的友	
右	左右	的右	
佑	保佑	的佑	
釉	瓷釉	的釉	
诱	诱	发的诱	
又	又	是的又	
幼	幼	年的幼	
迂	迂	回的迂	
淤	淤	泥的淤	
于	于	是的于	
盂	痰盂	的盂	
榆	榆	木的榆	
虞	不虞	的虞	
愚	愚	蠢的愚	
舆	舆	论的舆	
余	多余	的余	
逾	逾	期的逾	
鱼	鱼	虫的鱼	
愉	愉	快的愉	
渝	成渝	的渝	
渔	渔	夫的渔	
隅	象隅	的隅	
予	赐予	的予	
娱	娱	乐的娱	
雨	云雨	的雨	
与	与	共的与	
屿	岛屿	的屿	
禹	帝禹	的禹	
宇	宇	宙的宇	
语	语	文的语	
羽	羽	毛的羽	
玉	玉	米的玉	
域	区域	的域	
芋	芋	头的芋	
郁	忧郁	的郁	
遇	相遇	的遇	
喻	比喻	的喻	
峪	峪	谷的峪	
御	防御	的御	
愈	愈	合的愈	
欲	欲	望的欲	
狱	监狱	的狱	
育	教育	的育	
誉	在誉	的誉	
浴	浴	盆的浴	
寓	公寓	的寓	
裕	富裕	的裕	
预	预	备的预	
豫	豫	甥的豫	
驭	驾驭	的驭	
鸳	鸳	鸯的鸳	
渊	渊	博的渊	
冤	冤	枉的冤	
元	元	素的元	
垣	残垣	的垣	
袁	姓袁	的袁	
原	原	因的原	
援	援	助的援	
辕	车辕	的辕	
园	园	地的园	
员	员	工的员	
圆	方圆	的圆	
猿	猿	人的猿	
源	源	泉的源	
缘	缘	分的缘	
远	远	近的远	
苑	文苑	的苑	
愿	愿	望的愿	
怨	怨	恨的怨	
院	医院	的院	
曰	子曰	的曰	
约	约	定的约	
越	越	过的越	
跃	跳跃	的跃	
钥	钥	匙的钥	
岳	岳	飞的岳	
粤	粤	捍的粤	
月	日月	的月	
悦	喜悦	的悦	
阅	阅	览的阅	
耘	耕耘	的耘	
云	云	雨的云	
郧	郧	县的郧	
匀	均匀	的匀	
陨	陨	落的陨	
允	允	许的允	
运	运	动的运	
蕴	蕴	藏的蕴	
酝	酝	酿的酝	
晕	头晕	的晕	
韵	韵	母的韵	
孕	孕	妇的孕	
匝	匝	数的匝	
砸	砸	锅的砸	
杂	杂	乱的杂	
栽	栽	培的栽	
哉	哀哉	的哉	
灾	灾	祸的灾	
宰	屠宰	的宰	
载	载	重的载	
再	再	见的再	
在	在	于的在	
攒	攒	钱的攒	
暂	暂	时的暂	
赞	赞	成的赞	
赃	赃	物的赃	
脏	内脏	的脏	
葬	埋葬	的葬	
遭	遭	遇的遭	
糟	糟	粕的糟	
藻	求藻	的藻	
枣	大枣	的枣	
早	早	晨的早	
澡	洗澡	的澡	
蚤	跳蚤	的蚤	
躁	急躁	的躁	
噪	噪	声的噪	
造	制造	的造	
皂	肥皂	的皂	
灶	灶	火的灶	
燥	杆燥	的燥	
责	责	任的责	
则	法则	的则	
泽	光泽	的泽	
贼	公贼	的贼	
怎	怎	样的怎	
增	增	加的增	
憎	憎	恨的憎	
赠	赠	送的赠	
喳	喳	喳	的喳	
渣	渣	滓的渣	
札	札	记的札	
铡	铡	刀的铡	
闸	闸	门的闸	
眨	眨	眼的眨	
榨	榨	菜的榨	
乍	乍	普的乍	
炸	炸	弹的炸	
诈	欺诈	的诈	
摘	采摘	的摘	
斋	书斋	的斋	
宅	住宅	的宅	
窄	狭窄	的窄	
债	债	务的债	
寨	寨	子的寨	
瞻	瞻	望的瞻	
毡	毛毡	的毡	
詹	姓詹	的詹	
沾	沾	染的沾	
盏	灯盏	的盏	
斩	斩	首的斩	
辗	辗	转的辗	
崭	崭	新的崭	
展	展	开的展	
蘸	蘸	匠的蘸	
栈	客栈	的栈	
占	占	有的占	
战	战	争的战	
站	车站	的站	
湛	湛	江的湛	
绽	破绽	的绽	
樟	樟	脑的樟	
章	章	节的章	
彰	表彰	的彰	
漳	漳	河的漳	
张	张	开的张	
掌	掌	握的掌	
涨	涨	潮的涨	
杖	拐杖	的杖	
丈	丈	夫的丈	
帐	蚊帐	的帐	
账	账	户的账	
仗	打仗	的仗	
胀	膨胀	的胀	
瘴	瘴	气的瘴	
障	障	碍的障	
招	招	待的招	
昭	昭	然的昭	
找	寻找	的找	
沼	沼	泽的沼	
赵	姓赵	的赵	
照	照	亮的照	
罩	罩	子的罩	
兆	兆	头的兆	
肇	肇	事的肇	
召	召	唤的召	
遮	遮	蔽的遮	
哲	哲	学的哲	
蛰	惊蛰	的蛰	
辙	父辙	的辙	
者	作者	的者	
锗	金锗	的锗	
蔗	蔗	糖的蔗	
这	这	个的这	
浙	浙	江的浙	
珍	珍	宝的珍	
斟	斟	酌的斟	
真	真	假的真	
甄	姓甄	的甄	
砧	砧	板的砧	
臻	日臻	的臻	
贞	贞	操的贞	
针	金针	的针	
侦	侦	破的侦	
枕	枕	头的枕	
疹	麻疹	的疹	
诊	诊	所的诊	
震	震	撼的震	
振	振	动的振	
镇	镇	压的镇	
阵	方阵	的阵	
蒸	蒸	发的蒸	
挣	挣	脱的挣	
睁	睁	眼的睁	
征	常征	的征	
狰	狰	狞的狰	
争	斗争	的争	
怔	怔	呆的怔	
整	整	理的整	
拯	拯	救的拯	
正	正	好的正	
政	政	治的政	
帧	帧	幅的帧	
症	病症	的症	
郑	姓郑	的郑	
证	证	明的证	
芝	芝	麻的芝	
枝	枝	条的枝	
支	支	持的支	
蜘	蜘	蛛的蜘	
知	知	道的知	
肢	肢	体的肢	
脂	脂	肪的脂	
汁	乳汁	的汁	
之	之	后的之	
织	纺织	的织	
职	职	业的职	
直	直	线的直	
植	植	物的植	
执	执	行的执	
值	值	钱的值	
侄	侄	女的侄	
址	地址	的址	
指	指	望的指	
止	止	步的止	
趾	趾	高的趾	
只	只	要的只	
旨	宗旨	的旨	
纸	草纸	的纸	
志	志	气的志	
挚	挚	爱的挚	
掷	投掷	的掷	
至	至	此的至	
致	致	敬的致	
置	置	换的置	
帜	旗帜	的帜	
制	制	造的制	
智	智	慧的智	
秩	秩	序的秩	
稚	幼稚	的稚	
质	品质	的质	
炙	脍炙	的炙	
痔	痔	疮的痔	
滞	滞	后的滞	
治	治	理的治	
窒	窒	息的窒	
中	中	国的中	
盅	酒盅	的盅	
忠	忠	于的忠	
钟	钟	表的钟	
衷	衷	心的衷	
终	终	点的终	
肿	浮肿	的肿	
仲	仲	裁的仲	
众	群众	的众	
舟	舟	船的舟	
周	姓周	的周	
州	广州	的州	
洲	欧洲	的洲	
诌	胡诌	的诌	
粥	米粥	的粥	
轴	轴	心的轴	
肘	肘	子的肘	
帚	扫帚	的帚	
咒	咒	骂的咒	
皱	皮皱	的皱	
宙	宇宙	的宙	
昼	白昼	的昼	
骤	骤	然的骤	
珠	珍珠	的珠	
株	株	守的株	
蛛	蜘蛛	的蛛	
朱	姓朱	的朱	
猪	猪	肉的猪	
诸	诸	位的诸	
诛	口诛	的诛	
逐	驱逐	的逐	
竹	竹	竿的竹	
烛	蜡烛	的烛	
煮	煮	饭的煮	
拄	拄	棍的拄	
瞩	瞩	目的瞩	
嘱	嘱	咐的嘱	
主	主	人的主	
著	著	作的著	
柱	柱	石的柱	
助	帮助	的助	
蛀	蛀	虫的蛀	
贮	贮	存的贮	
铸	铸	铁的铸	
筑	建筑	的筑	
住	住	房的住	
注	注	意的注	
祝	祝	贺的祝	
驻	驻	地的驻	
抓	抓	紧的抓	
专	专	心的专	
砖	砖	头的砖	
转	转	动的转	
撰	撰	写的撰	
篆	篆	字的篆	
桩	木桩	的桩	
庄	庄	严的庄	
装	装	置的装	
妆	化妆	的妆	
撞	撞	倒的撞	
壮	壮	丽的壮	
状	状	态的状	
锥	锥	子的锥	
追	追	捕的追	
赘	雷赘	的赘	
坠	坠	落的坠	
缀	点缀	的缀	
谆	谆	谆	的谆	
准	准	备的准	
捉	捕捉	的捉	
拙	拙	劣的拙	
卓	卓	越的卓	
桌	桌	子的桌	
琢	琢	磨的琢	
茁	茁	壮的茁	
酌	酌	情的酌	
啄	啄	米的啄	
灼	灼	热的灼	
浊	污浊	的浊	
兹	兹	此的兹	
咨	咨	询的咨	
资	资	本的资	
姿	姿	态的姿	
滋	滋	味的滋	
淄	淄	河的淄	
孜	孜	孜	的孜	
紫	紫	色的紫	
籽	棉籽	的籽	
滓	渣滓	的滓	
子	子	孙的子	
自	自	己的自	
渍	茶渍	的渍	
字	字	典的字	
鬃	鬃	毛的鬃	
棕	棕	榈的棕	
踪	行踪	的踪	
宗	宗	教的宗	
综	综	合的综	
总	总	共的总	
纵	放纵	的纵	
邹	姓邹	的邹	
走	走	路的走	
奏	奏	乐的奏	
揍	挨揍	的揍	
租	租	借的租	
足	足	够的足	
卒	兵卒	的卒	
族	民族	的族	
祖	祖	国的祖	
诅	诅	咒的诅	
阻	阻	力的阻	
组	组	合的组	
钻	钻	研的钻	
纂	纂	写的纂	
嘴	嘴	巴的嘴	
醉	喝醉	的醉	
最	最	好的最	
罪	罪	行的罪	
尊	尊	重的尊	
遵	遵	命的遵	
昨	昨	天的昨	
左	左	右的左	
佐	俯佐	的佐	
做	做	工的做	
作	工作	的作	
坐	坐	立的坐	
座	座	位的座	
亍	彳亍	的亍	
丌	丌	作的丌	
兀	突兀	的兀	
丐	乞丐	的丐	
廿	二十的廿	
卅	三十的卅	
丕	丕	业的丕	
亘	横亘	的亘	
丞	丞	相的丞	
孬	孬	种的孬	
噩	噩	梦的噩	
丨	竖线的丨	
禺	番禺	的禺	
丿	一撇的丿	
匕	匕	首的匕	
乇	乇	一的乇	
夭	夭	折的夭	
爻	爻	挂的爻	
卮	漏卮	的卮	
氐	氐	族的氐	
囟	囟	门的囟	
胤	匡胤	的胤	
馗	中馗	的馗	
毓	毓	秀的毓	
睾	睾	丸的睾	
鼗	鼗	鼓的鼗	
丶	一点的丶	
亟	亟	待的亟	
鼐	鼎鼐	的鼐	
乩	扶乩	的乩	
亓	姓亓	的亓	
芈	姓芈	的芈	
啬	吝啬	的啬	
仄	平仄	的仄	
厍	姓厍	的厍	
厝	厝	放的厝	
厣	厣	贾的厣	
厥	昏厥	的厥	
厮	厮	打的厮	
靥	笑靥	的靥	
赝	赝	品的赝	
匚	字框的匚	
叵	叵	测的叵	
匦	票匦	的匦	
匮	匮	乏的匮	
匾	匾	额的匾	
赜	微赜	的赜	
卦	八卦	的卦	
卣	卣	瓶的卣	
刂	刀旁的刂	
刈	刈	割的刈	
刎	自刎	的刎	
刭	自刭	的刭	
刳	刀刳	的刳	
刿	刿	割的刿	
剀	刀剀	的剀	
剌	剌	撒的剌	
剞	剞	劂的剞	
剜	剜	肉的剜	
蒯	姓蒯	的蒯	
剽	剽	窃的剽	
劂	剞劂	的劂	
劁	劁	猪的劁	
劐	劐	开的劐	
劓	劓	刑的劓	
冂	字框的冂	
罔	罔	闻的罔	
亻	人旁的亻	
仃	伶仃	的仃	
仉	姓仉	的仉	
仂	仂	语的仂	
仨	仨	人的仨	
仫	仫	佬的仫	
仞	万仞	的仞	
伛	伛	偻的伛	
仳	仳	离的仳	
伢	伢	子的伢	
佤	佤	族的佤	
仵	仵	作的仵	
伥	作伥	的伥	
伉	伉	俪的伉	
伫	伫	立的伫	
佞	人佞	的佞	
佧	佧	佤的佧	
攸	攸	关的攸	
佝	佝	偻的佝	
佟	姓佟	的佟	
佗	华佗	的佗	
伲	我伲	的伲	
佶	佶	区的佶	
侑	侑	觞的侑	
侉	侉	子的侉	
侃	调侃	的侃	
侏	侏	儒的侏	
佾	佾	舞的佾	
佻	轻佻	的佻	
侪	侪	辈的侪	
佼	佼	佼	的佼	
侬	侬	好的侬	
侔	相侔	的侔	
俦	俦	侣的俦	
俨	俨	如的俨	
俪	伉俪	的俪	
俅	俅	人的俅	
俚	俚	俗的俚	
俣	俣	俣	的俣	
俜	伶俜	的俜	
俑	陶俑	的俑	
俸	俸	禄的俸	
倩	倩	影的倩	
偌	偌	大的偌	
俳	俳	谐的俳	
倬	倬	著的倬	
倏	倏	地的倏	
倮	倮	人的倮	
倭	倭	寇的倭	
俾	俾	倪的俾	
倜	倜	傥的倜	
倌	羊倌	的倌	
倥	倥	偬的倥	
倨	倨	傲的倨	
偾	偾	氏的偾	
偃	偃	旗的偃	
偕	偕	同的偕	
偎	偎	依的偎	
偬	倥偬	的偬	
傥	倜傥	的傥	
傧	男傧	的傧	
傩	傩	神的傩	
傺	杈傺	的傺	
僖	僖	乐的僖	
儆	儆	戒的儆	
僭	僭	越的僭	
僬	僬	尧的僬	
僦	租僦	的僦	
儇	儇	利的儇	
儋	儋	县的儋	
仝	仝	样的仝	
氽	油氽	的氽	
佘	佘	太的佘	
佥	佥	全的佥	
俎	俎	斗的俎	
龠	乐器的龠	
汆	撺汤的汆	
籴	籴	买的籴	
兮	叹兮	的兮	
巽	巽	卦的巽	
黉	黉	学的黉	
馘	馘	耳的馘	
冁	冁	然的冁	
夔	夔	州的夔	
勹	字头的勹	
匍	匍	匐的匍	
訇	阿訇	的訇	
匐	匍匐	的匐	
凫	野鸭的凫	
夙	夙	愿的夙	
兕	兕	牛的兕	
亠	字头的亠	
兖	兖	州的兖	
亳	亳	县的亳	
衮	衮	服的衮	
袤	广袤	的袤	
亵	亵	渎的亵	
脔	脔	割的脔	
裒	裒	辑的裒	
禀	禀	告的禀	
嬴	嬴	政的嬴	
蠃	蜾蠃	的蠃	
羸	羸	弱的羸	
冫	点水的冫	
冱	冱	寒的冱	
冽	凛冽	的冽	
冼	姓冼	的冼	
凇	雾凇	的凇	
冖	宝盖的冖	
冢	古冢	的冢	
冥	冥	思的冥	
讠	字旁的讠	
讦	攻讦	的讦	
讧	内讧	的讧	
讪	讪	笑的讪	
讴	讴	歌的讴	
讵	讵	料的讵	
讷	木讷	的讷	
诂	训诂	的诂	
诃	诃	子的诃	
诋	诋	毁的诋	
诏	诏	书的诏	
诎	诎	缩的诎	
诒	诒	训的诒	
诓	诓	骗的诓	
诔	诔	为的诔	
诖	诖	误的诖	
诙	诙	谐的诙	
诜	研诜	的诜	
诟	诟	骂的诟	
诠	诠	注的诠	
诤	诤	言的诤	
诨	诨	号的诨	
诩	自诩	的诩	
诮	讥诮	的诮	
诰	诰	命的诰	
诳	诳	语的诳	
诹	言诹	的诹	
诼	诼	毁的诼	
诿	推诿	的诿	
谀	讹谀	的谀	
谂	谂	知的谂	
谄	谄	媚的谄	
谇	谇	骂的谇	
谌	姓谌	的谌	
谏	进谏	的谏	
谑	戏谑	的谑	
谒	谒	见的谒	
谔	谔	谔	的谔	
谕	首谕	的谕	
谖	欺骗的谖	
谙	谙	练的谙	
谛	谛	听的谛	
谘	谘	文的谘	
谝	谝	能的谝	
谟	宏谟	的谟	
谠	谠	言的谠	
谡	谡	起的谡	
谥	称做的谥	
谧	安谧	的谧	
谪	谪	居的谪	
谫	谫	陋的谫	
谮	谮	言的谮	
谯	谯	楼的谯	
谲	谲	诈的谲	
谳	谳	判的谳	
谵	谵	语的谵	
谶	言谶	的谶	
卩	耳刀的卩	
卺	合卺	的卺	
阝	耳朵的阝	
阢	阢	陧的阢	
阡	阡	陌的阡	
阱	陷阱	的阱	
阪	阪	田的阪	
阽	阽	危的阽	
阼	阼	台的阼	
陉	山陉	的陉	
陔	陔	级的陔	
陟	陟	高的陟	
陧	杌陧	的陧	
陬	陬	角的陬	
陲	边陲	的陲	
陴	陴	墙的陴	
隈	山隈	的隈	
隍	城隍	的隍	
隗	姓隗	的隗	
隰	隰	湿的隰	
邗	邗	江的邗	
邛	邛	崃的邛	
邝	姓邝	的邝	
邙	北邙	的邙	
邬	姓邬	的邬	
邡	邡	县的邡	
邴	姓邴	的邴	
邳	姓邳	的邳	
邶	邶	国的邶	
邺	邺	都的邺	
邸	官邸	的邸	
邰	姓邰	的邰	
郏	郏	县的郏	
郅	姓郅	的郅	
邾	邾	国的邾	
郐	郐	国的郐	
郄	姓郄	的郄	
郓	郓	城的郓	
郦	姓郦	的郦	
郢	郢	都的郢	
郜	姓郜	的郜	
郗	姓郗	的郗	
郛	郛	城的郛	
郫	郫	县的郫	
郯	郯	城的郯	
郾	郾	城的郾	
鄄	鄄	城的鄄	
鄢	鄢	陵的鄢	
鄞	鄞	县的鄞	
鄣	鄣	国的鄣	
鄱	鄱	阳的鄱	
鄯	鄯	国的鄯	
鄹	鄹	国的鄹	
酃	酃	县的酃	
酆	酆	都的酆	
刍	刍	议的刍	
奂	奂	文的奂	
劢	力劢	的劢	
劬	劬	劳的劬	
劭	得劭	的劭	
劾	弹劾	的劾	
哿	哿	赞的哿	
勐	勐	海的勐	
勖	勖	勉的勖	
勰	勰	调的勰	
叟	老叟	的叟	
燮	燮	理的燮	
矍	矍	铄的矍	
廴	字旁的廴	
凵	字底的凵	
凼	凼	肥的凼	
鬯	欢鬯	的鬯	
厶	字边的厶	
弁	马弁	的弁	
畚	畚	箕的畚	
巯	巯	基的巯	
坌	坌	土的坌	
垩	白垩	的垩	
垡	耕垡	的垡	
塾	私塾	的塾	
墼	炭墼	的墼	
壅	壅	土的壅	
壑	沟壑	的壑	
圬	抹墙的圬	
圪	土圪	的圪	
圳	深圳	的圳	
圹	圹	穴的圹	
圮	圮	毁的圮	
圯	圯	桥的圯	
坜	中坜	的坜	
坂	大坂	的坂	
坩	坩	埚的坩	
垅	垅	沟的垅	
坫	土坫	的坫	
垆	垆	土的垆	
坼	坼	裂的坼	
坨	土坨	的坨	
坭	白坭	的坭	
坶	垆坶	的坶	
坳	山坳	的坳	
垭	垭	口的垭	
垤	丘垤	的垤	
垲	爽垲	的垲	
埏	土埏	的埏	
垧	垧	地的垧	
垴	垴	山的垴	
垓	垓	下的垓	
垠	无垠	的垠	
埕	土埕	的埕	
埘	埘	窝的埘	
埚	坩埚	的埚	
埙	陶埙	的埙	
埒	相埒	的埒	
垸	垸	田的垸	
埴	埴	土的埴	
埯	土埯	的埯	
埸	疆埸	的埸	
埝	埝	埂的埝	
堋	堋	堤的堋	
堍	桥堍	的堍	
埽	埽	堤的埽	
埭	土埭	的埭	
堀	堀	洞的堀	
堞	城堞	的堞	
堙	土山的堙	
塄	塄	坎的塄	
堠	土堠	的堠	
塥	沙塥	的塥	
塬	塬	台的塬	
墁	墁	地的墁	
墉	城墉	的墉	
墚	山墚	的墚	
墀	墀	台的墀	
馨	馨	香的馨	
鼙	鼓鼙	的鼙	
懿	懿	美的懿	
艹	字头的艹	
艽	秦艽	的艽	
艿	芋艿	的艿	
芏	茳芏	的芏	
芊	芊	绵的芊	
芨	白芨	的芨	
芄	芄	兰的芄	
芎	川芎	的芎	
芑	芑	菜的芑	
芗	芗	江的芗	
芙	芙	蓉的芙	
芸	芸	豆的芸	
芰	芰	菱的芰	
苈	葶苈	的苈	
苊	务苊	的苊	
芘	草芘	的芘	
芷	白芷	的芷	
芮	姓芮	的芮	
苋	苋	菜的苋	
苌	草苌	的苌	
苁	苁	蓉的苁	
芩	黄芩	的芩	
芴	草芴	的芴	
芡	芡	粉的芡	
芪	黄芪	的芪	
芟	芟	草的芟	
苄	草苄	的苄	
苎	住麻的苎	
芤	芤	脉的芤	
苡	苡	米的苡	
茉	茉	莉的茉	
苷	糖苷	的苷	
苤	苤	蓝的苤	
茏	茏	葱的茏	
茇	草茇	的茇	
苜	苜	蓿的苜	
苴	苴	麻的苴	
苒	荏苒	的苒	
苘	苘	麻的苘	
茌	茌	平的茌	
苻	姓苻	的苻	
苓	茯苓	的苓	
茑	茑	萝的茑	
茚	茚	液的茚	
茆	白茆	的茆	
茔	祖茔	的茔	
茕	茕	茕	的茕	
苠	苠	晚的苠	
荛	荛	花的荛	
荜	荜	拨的荜	
莒	莒	县的莒	
茼	茼	蒿的茼	
茴	茴	香的茴	
茱	茱	萸的茱	
莛	莛	睛的莛	
荞	荞	麦的荞	
茯	茯	苓的茯	
荏	荏	苒的荏	
荇	荇	菜的荇	
荃	荃	草的荃	
荟	荟	萃的荟	
荀	荀	子的荀	
茗	香茶的茗	
茭	茭	白的茭	
茺	茺	蔚的茺	
茳	草茳	的茳	
荦	卓荦	的荦	
荨	前麻的荨	
茛	毛茛	的茛	
荩	荩	草的荩	
荬	苣荬	的荬	
荪	荪	草的荪	
荭	荭	草的荭	
荮	一荮	的荮	
莰	莰	烷的莰	
荸	荸	荠的荸	
莳	莳	萝的莳	
莴	莴	苣的莴	
莠	良莠	的莠	
莪	莪	蒿的莪	
莓	草莓	的莓	
莜	莜	麦的莜	
莅	莅	会的莅	
荼	荼	毒的荼	
莶	莶	草的莶	
荽	芫荽	的荽	
莸	莸	草的莸	
荻	荻	草的荻	
莘	莘	县的莘	
莺	黄莺	的莺	
莼	莼	菜的莼	
菁	存菁	的菁	
萁	豆萁	的萁	
菥	菥	明的菥	
菘	菘	菜的菘	
堇	堇	菜的堇	
萘	萘	物的萘	
萋	萋	萋	的萋	
菝	菝	葜的菝	
菽	菽	粟的菽	
菖	菖	蒲的菖	
萜	萜	水的萜	
萸	茱萸	的萸	
萑	草萑	的萑	
菔	莱菔	的菔	
菟	菟	丝的菟	
萏	菡萏	的萏	
萃	萃	取的萃	
菸	菸	草的菸	
菹	草菹	的菹	
菪	莨菪	的菪	
菅	草菅	的菅	
菀	菀	紫的菀	
萦	萦	绕的萦	
菰	草菰	的菰	
菡	菡	花的菡	
葜	菝葜	的葜	
葑	草葑	的葑	
葚	桑葚	的葚	
葙	青葙	的葙	
葳	葳	蕤的葳	
蒇	蒇	事的蒇	
蒈	草蒈	的蒈	
葺	修葺	的葺	
蒉	包蒉	的蒉	
葸	畏葸	的葸	
萼	萼	片的萼	
葆	永葆	的葆	
葩	奇葩	的葩	
葶	葶	苈的葶	
蒌	蒌	蒿的蒌	
蒎	蒎	烯的蒎	
萱	萱	草的萱	
葭	草葭	的葭	
蓁	蓁	蓁	的蓁	
蓍	蓍	草的蓍	
蓐	坐蓐	的蓐	
蓦	蓦	然的蓦	
蒽	蒽	物的蒽	
蓓	蓓	蕾的蓓	
蓊	蓊	郁的蓊	
蒿	蒿	草的蒿	
蒺	蒺	藜的蒺	
蓠	淋蓠	的蓠	
蒡	牛蒡	的蒡	
蒹	芦蒹	的蒹	
蒴	蒴	果的蒴	
蒗	宁蒗	的蒗	
蓥	华蓥	的蓥	
蓣	薯蓣	的蓣	
蔌	蔌	菜的蔌	
甍	甍	瓷的甍	
蔸	蔸	草的蔸	
蓰	倍蓰	的蓰	
蔹	白蔹	的蔹	
蔟	蚕蔟	的蔟	
蔺	姓蔺	的蔺	
蕖	芙蕖	的蕖	
蔻	蔻	丹的蔻	
蓿	苜蓿	的蓿	
蕙	蕙	草的蕙	
蕈	蕈	树的蕈	
蕨	蕨	菜的蕨	
蕤	葳蕤	的蕤	
蕞	蕞	尔的蕞	
蕺	草蕺	的蕺	
瞢	瞢	然的瞢	
蕃	蕃	茄的蕃	
蕲	蕲	蛇的蕲	
蕻	雪蕻	的蕻	
薤	草薤	的薤	
薨	死薨	的薨	
薇	蔷薇	的薇	
薏	薏	苡的薏	
蕹	蕹	菜的蕹	
薮	渊薮	的薮	
薜	薜	荔的薜	
薅	薅	锄的薅	
薹	蒜薹	的薹	
薷	香薷	的薷	
薰	薰	暖的薰	
藓	藓	苔的藓	
藁	藁	城的藁	
藜	极藜	的藜	
藿	藿	香的藿	
蘧	蘧	然的蘧	
蘅	杜蘅	的蘅	
蘩	草繁的蘩	
蘖	分蘖	的蘖	
蘼	蘼	芜的蘼	
廾	字底的廾	
弈	对弈	的弈	
夼	大夼	的夼	
奁	妆奁	的奁	
耷	耷	拉的耷	
奕	光明的奕	
奚	奚	落的奚	
奘	玄奘	的奘	
匏	匏	瓜的匏	
尥	蹶子的尥	
尬	尴尬	的尬	
尴	尴	尬的尴	
扌	手旁的扌	
扪	扪	心的扪	
抟	抟	旋的抟	
抻	抻	面的抻	
拊	拊	掌的拊	
拚	拚	命的拚	
拮	拮	据的拮	
挢	挢	举的挢	
挹	挹	注的挹	
捃	拾取的捃	
掭	掭	笔的掭	
揶	揶	揄的揶	
捱	难捱	的捱	
捺	撇捺	的捺	
掎	掎	拖的掎	
捭	捭	阖的捭	
掬	渴掬	的掬	
掊	掊	击的掊	
捩	捩	转的捩	
掮	掮	客的掮	
掼	掼	衰的掼	
揲	折叠的揲	
揸	揸	物的揸	
揠	揠	苗的揠	
揿	揿	按的揿	
揄	揄	扬的揄	
揞	提揞	的揞	
揎	揎	开的揎	
摒	摒	弃的摒	
揆	揆	度的揆	
掾	掾	属的掾	
摅	摅	意的摅	
摁	摁	钉的摁	
搋	搋	子的搋	
搛	搛	菜的搛	
搠	搠	扎的搠	
搌	搌	布的搌	
搦	搦	战的搦	
搡	推搡	的搡	
摞	砖摞	的摞	
撄	撄	扰的撄	
摭	摭	拾的摭	
撖	提撖	的撖	
摺	摺	叠的摺	
撷	采撷	的撷	
撸	撸	下的撸	
撙	撙	节的撙	
撺	撺	弄的撺	
擀	擀	面的擀	
擐	擐	甲的擐	
擗	擗	踊的擗	
擤	擤	涕的擤	
擢	擢	升的擢	
攉	攉	土的攉	
攥	攥	紧的攥	
攮	攮	子的攮	
弋	或弋	的弋	
甙	甙	糖的甙	
弑	弑	君的弑	
卟	卟	粉的卟	
叱	叱	责的叱	
叽	叽	咕的叽	
叩	叩	头的叩	
叻	叻	币的叻	
吒	哪吒	的吒	
吆	吆	喝的吆	
呋	呋	喃的呋	
呒	没有的呒	
呓	梦呓	的呓	
呖	呖	呖	的呖	
呃	呃	逆的呃	
呙	呙	斜的呙	
吣	吣	食的吣	
吲	吲	哚的吲	
咂	咂	嘴的咂	
咔	咔	叽的咔	
呷	口呷	的呷	
呱	刮呱	的呱	
呤	嘌呤	的呤	
咚	咚	咚	的咚	
咛	叮咛	的咛	
咄	咄	咄	的咄	
呶	呶	呶	的呶	
呦	呦	叹的呦	
咝	咝	声的咝	
哐	哐	啷的哐	
咭	嘟囔的咭	
哂	哂	纳的哂	
咴	咴	叫的咴	
哒	卡哒	的哒	
咧	咧	咧	的咧	
咦	咦	叹的咦	
哓	哓	哓	的哓	
哔	哔	叽的哔	
咣	咣	声的咣	
哕	鸟哕	的哕	
咻	咻	咻	的咻	
咿	咿	呀的咿	
哌	哌	嗪的哌	
哙	哙	咽的哙	
哚	吲哚	的哚	
哜	品尝的哜	
咩	咩	咩	的咩	
咪	咪	咪	的咪	
咤	叱咤	的咤	
哝	哝	哝	的哝	
哏	逗哏	的哏	
哞	哞	哞	的哞	
唛	唛	分的唛	
哧	哧	溜的哧	
唠	唠	叨的唠	
哽	哽	咽的哽	
唔	咿唔	的唔	
哳	啁哳	的哳	
唢	唢	呐的唢	
唣	罗唣	的唣	
唏	唏	嘘的唏	
唑	噻唑	的唑	
唧	唧	筒的唧	
唪	唪	念的唪	
啧	啧	啧	的啧	
喵	喵	喵	的喵	
啉	喹啉	的啉	
啭	啭	鸣的啭	
啕	号啕	的啕	
唿	唿	哨的唿	
啐	啐	痰的啐	
唼	唼	喋的唼	
唷	叹词的唷	
啖	啖	饭的啖	
啵	啵	叹的啵	
啶	吡啶	的啶	
啷	哐啷	的啷	
唳	鹤唳	的唳	
唰	唰	唰	的唰	
喋	喋	血的喋	
喃	喃	喃	的喃	
喱	咖喱	的喱	
喹	喹	啉的喹	
喈	喈	喈	的喈	
喁	喁	喁	的喁	
喟	喟	叹的喟	
啾	啾	啾	的啾	
嗖	嗖	嗖	的嗖	
喑	喑	哑的喑	
啻	不啻	的啻	
喽	喽	螺的喽	
喾	帝喾	的喾	
喙	百喙	的喙	
嗪	哌嗪	的嗪	
嗷	嗷	嗷	的嗷	
嗉	嗉	子的嗉	
嘟	嘟	囔的嘟	
嗑	唠嗑	的嗑	
嗫	嗫	嚅的嗫	
嗬	嗬	吆的嗬	
嗔	嗔	怪的嗔	
嗦	哆嗦	的嗦	
嗝	打嗝	的嗝	
嗯	叹词的嗯	
嗥	狼嗥	的嗥	
嗲	嗲	声的嗲	
嗳	嗳	气的嗳	
嗍	嗍	奶的嗍	
嗵	扑嗵	的嗵	
嗤	嗤	笑的嗤	
辔	辔	头的辔	
嘞	好嘞	的嘞	
嘈	嘈	杂的嘈	
嘌	嘌	另的嘌	
嘁	嘁	喳的嘁	
嘤	嘤	叫的嘤	
嘣	嘣	嘣	的嘣	
嗾	嗾	使的嗾	
嘀	嘀	嗒的嘀	
嘧	嘧	啶的嘧	
嘭	嘭	嘭	的嘭	
噘	噘	嘴的噘	
嘹	嘹	亮的嘹	
噗	噗	嗤的噗	
嘬	嘬	奶的嘬	
噍	噍	类的噍	
噢	钌解的噢	
噙	噙	着的噙	
噜	噜	苏的噜	
噔	口噔	的噔	
嚆	嚆	矢的嚆	
噤	噤	声的噤	
噫	噫	互的噫	
噻	噻	吩的噻	
噼	噼	噼	的噼	
嚅	嗫嚅	的嚅	
嚯	嚯	惊的嚯	
囔	囔	囔	的囔	
囗	方框的囗	
囡	小囡	的囡	
囵	囫囵	的囵	
囫	囫	囵的囫	
囹	囹	圄的囹	
囿	囿	于的囿	
圄	囹圄	的圄	
圊	圊	肥的圊	
圉	马圉	的圉	
帏	帏	香的帏	
帙	帙	套的帙	
帔	霞帔	的帔	
帑	帑	银的帑	
帻	金帻	的帻	
帼	巾帼	的帼	
帷	帷	幕的帷	
幄	帷幄	的幄	
幔	幔	帐的幔	
幛	寿幛	的幛	
幞	经幞	的幞	
幡	幡	然的幡	
岌	岌	微的岌	
屺	山屺	的屺	
岍	岍	山的岍	
岐	突岐	的岐	
岖	崎岖	的岖	
岈	山牙的岈	
岘	山岘	的岘	
岙	山岙	的岙	
岑	岑	寂的岑	
岚	山岚	的岚	
岵	草岵	的岵	
岢	岢	岚的岢	
岽	岽	罗的岽	
岬	山岬	的岬	
岫	远岫	的岫	
岱	岱	岳的岱	
岣	岣	嵝的岣	
峁	山峁	的峁	
岷	岷	山的岷	
峄	峄	山的峄	
峋	嶙峋	的峋	
峥	峥	嵘的峥	
崂	崂	山的崂	
崃	邛崃	的崃	
崧	山崧	的崧	
崦	崦	嵫的崦	
崮	梦崮	的崮	
崤	崤	陵的崤	
崞	崞	县的崞	
崆	崆	峒的崆	
崛	崛	起的崛	
嵘	峥嵘	的嵘	
崾	山崾	的崾	
崽	崽	子的崽	
嵬	嵬	然的嵬	
嵛	昆嵛	的嵛	
嵯	嵯	峨的嵯	
嵝	山嵝	的嵝	
嵫	崦嵫	的嵫	
嵋	峨嵋	的嵋	
嵊	嵊	县的嵊	
嵩	嵩	山的嵩	
嵴	山脊的嵴	
嶂	叠嶂	的嶂	
嶙	嶙	峋的嶙	
嶝	嶝	山的嶝	
豳	豳	县的豳	
嶷	九嶷	的嶷	
巅	山巅	的巅	
彳	彳	亍的彳	
彷	彷	徨的彷	
徂	网徂	的徂	
徇	徇	私的徇	
徉	徜徉	的徉	
後	後	换的後	
徕	招徕	的徕	
徙	迁徙	的徙	
徜	徜	徉的徜	
徨	彷徨	的徨	
徭	徭	役的徭	
徼	请求的徼	
衢	通衢	的衢	
彡	彡	撇的彡	
犭	犬旁的犭	
犰	犰	狳的犰	
犴	狴犴	的犴	
犷	粗犷	的犷	
犸	猛犸	的犸	
狃	狃	于的狃	
狁	犭允的狁	
狎	狎	昵的狎	
狍	狍	子的狍	
狒	狒	狒	的狒	
狨	狨	猴的狨	
狯	狡狯	的狯	
狩	狩	猎的狩	
狲	猢狲	的狲	
狴	狴	犴的狴	
狷	狷	急的狷	
猁	猞猁	的猁	
狳	犰狳	的狳	
猃	猃	狁的猃	
狺	犬狺	的狺	
狻	狻	猊的狻	
猗	涟猗	的猗	
猓	猓	然的猓	
猡	猪猡	的猡	
猊	狻猊	的猊	
猞	猞	猁的猞	
猝	猝	然的猝	
猕	猕	猴的猕	
猢	猢	狲的猢	
猹	蜷猹	的猹	
猥	猥	亵的猥	
猬	刺猬	的猬	
猸	猸	子的猸	
猱	猱	猴的猱	
獐	獐	子的獐	
獍	獍	兽的獍	
獗	猖獗	的獗	
獠	獠	牙的獠	
獬	獬	豸的獬	
獯	獯	猃的獯	
獾	狗獾	的獾	
舛	舛	误的舛	
夥	夥	同的夥	
飧	飧	参的飧	
夤	夤	缘的夤	
夂	字头的夂	
饣	字旁的饣	
饨	馄饨	的饨	
饩	饩	料的饩	
饪	烹饪	的饪	
饫	时饫	的饫	
饬	饬	令的饬	
饴	饴	糖的饴	
饷	关饷	的饷	
饽	饽	饽	的饽	
馀	多馀	的馀	
馄	馄	饨的馄	
馇	馇	粥的馇	
馊	馊	饭的馊	
馍	蒸馍	的馍	
馐	珍馐	的馐	
馑	饥馑	的馑	
馓	馓	子的馓	
馔	盛馔	的馔	
馕	馕	饼的馕	
庀	庀	备的庀	
庑	庑	殿的庑	
庋	庋	藏的庋	
庖	庖	厨的庖	
庥	庥	保的庥	
庠	庠	声的庠	
庹	姓庹	的庹	
庵	庵	堂的庵	
庾	谷仓的庾	
庳	庳	矮的庳	
赓	赓	续的赓	
廒	廒	仓的廒	
廑	廑	廑	的廑	
廛	廛	房的廛	
廨	廨	署的廨	
廪	仓廪	的廪	
膺	膺	选的膺	
忄	心旁的忄	
忉	忉	忉	的忉	
忖	自忖	的忖	
忏	忏	悔的忏	
怃	怃	然的怃	
忮	嫉妒的忮	
怄	怄	气的怄	
忡	忡	忡	的忡	
忤	忤	逆的忤	
忾	敌忾	的忾	
怅	怅	然的怅	
怆	怆	然的怆	
忭	忭	喜的忭	
忸	忸	怩的忸	
怙	失怙	的怙	
怵	怵	惕的怵	
怦	怦	然的怦	
怛	怛	忧的怛	
怏	怏	怏	的怏	
怍	愧怍	的怍	
怩	忸怩	的怩	
怫	怫	忧的怫	
怊	怊	怅的怊	
怿	怿	欢的怿	
怡	怡	乐的怡	
恸	悲恸	的恸	
恹	恹	恹	的恹	
恻	恻	隐的恻	
恺	恺	乐的恺	
恂	恂	恐的恂	
恪	恪	守的恪	
恽	姓恽	的恽	
悖	悖	谬的悖	
悚	悚	然的悚	
悭	悭	吝的悭	
悝	李悝	的悝	
悃	悃	谢的悃	
悒	愁悒	的悒	
悌	孝悌	的悌	
悛	不悛	的悛	
惬	惬	意的惬	
悻	悻	然的悻	
悱	悱	恻的悱	
惝	新惝	的惝	
惘	惘	然的惘	
惆	惆	怅的惆	
惚	恍惚	的惚	
悴	憔悴	的悴	
愠	愠	色的愠	
愦	昏愦	的愦	
愕	愕	然的愕	
愣	发愣	的愣	
惴	惴	惴	的惴	
愀	愀	然的愀	
愎	刚愎	的愎	
愫	情愫	的愫	
慊	慊	恨的慊	
慵	慵	困的慵	
憬	憬	悟的憬	
憔	憔	悴的憔	
憧	憧	憬的憧	
憷	憷	场的憷	
懔	懔	惧的懔	
懵	懵	懂的懵	
忝	忝	列的忝	
隳	隳	毁的隳	
闩	门闩	的闩	
闫	闫	罗的闫	
闱	闱	墨的闱	
闳	门闳	的闳	
闵	姓闵	的闵	
闶	闶	阆的闶	
闼	小门的闼	
闾	闾	巷的闾	
阃	规捆的阃	
阄	抓阄	的阄	
阆	闶阆	的阆	
阈	直阈	的阈	
阊	门阊	的阊	
阋	阋	墙的阋	
阌	阌	乡的阌	
阍	扣阍	的阍	
阒	阒	寂的阒	
阕	乐阕	的阕	
阖	阖	家的阖	
阗	喧阗	的阗	
阙	宫阙	的阙	
丬	字旁的丬	
爿	柴爿	的爿	
戕	戕	害的戕	
氵	点水的氵	
汔	汔	几的汔	
汜	汜	水的汜	
汊	和汊	的汊	
沣	沣	水的沣	
沅	沅	江的沅	
沐	沐	浴的沐	
沔	沔	水的沔	
沌	混沌	的沌	
汨	汨	罗的汨	
汩	水声的汩	
汴	汴	京的汴	
汶	汶	水的汶	
沆	沆	瀣的沆	
沩	沩	水的沩	
泐	实泐	的泐	
泔	泔	水的泔	
沭	沭	河的沭	
泸	泸	定的泸	
泱	泱	泱	的泱	
泗	水泗	的泗	
沲	水沲	的沲	
泠	泠	风的泠	
泖	泖	湖的泖	
泫	水泫	的泫	
泮	泮	宫的泮	
沱	沱	茶的沱	
泓	一泓	的泓	
泯	泯	灭的泯	
泾	泾	河的泾	
洹	洹	水的洹	
洧	洧	川的洧	
洌	酒洌	的洌	
浃	浃	透的浃	
浈	浈	水的浈	
洇	洇	湿的洇	
洄	洄	游的洄	
洙	洙	水的洙	
洎	水洎	的洎	
洫	沟洫	的洫	
洮	洮	河的洮	
洵	洵	之的洵	
洚	洚	水的洚	
浏	浏	览的浏	
浔	浔	洋的浔	
洳	沮洳	的洳	
涑	涑	水的涑	
浯	浯	河的浯	
涞	涞	县的涞	
涠	涠	洲的涠	
浞	浞	雨的浞	
涓	水涓	的涓	
涔	涔	涔	的涔	
浜	和浜	的浜	
浠	水明的浠	
浼	浼	托的浼	
浣	水浣	的浣	
渚	渚	地的渚	
淇	兵淇	的淇	
淅	淅	沥的淅	
淞	吴淞	的淞	
渎	渎	直的渎	
涿	涿	县的涿	
淠	淠	河的淠	
淦	姓淦	的淦	
淝	淝	水的淝	
淙	淙	淙	的淙	
渖	墨渖	的渖	
涫	沸涫	的涫	
渌	渌	水的渌	
涮	洗涮	的涮	
渫	渫	除的渫	
湎	沉湎	的湎	
溲	溲	溺的溲	
湟	湟	水的湟	
溆	溆	浦的溆	
湓	湓	涌的湓	
湔	湔	雪的湔	
渲	渲	染的渲	
渥	优渥	的渥	
湄	水边的湄	
滟	滟	练的滟	
溘	溘	是的溘	
滠	滠	口的滠	
漭	漭	漭	的漭	
滢	滢	清的滢	
溥	姓溥	的溥	
溧	溧	阳的溧	
溽	溽	暑的溽	
溻	溻	汗的溻	
溷	溷	浊的溷	
滗	水滗	的滗	
溴	溴	点的溴	
滏	滏	阳的滏	
溏	溏	便的溏	
滂	滂	沱的滂	
溟	溟	河的溟	
潢	装潢	的潢	
潆	潆	洄的潆	
潇	潇	洒的潇	
漤	漤	味的漤	
漕	漕	运的漕	
滹	滹	沱的滹	
漯	漯	河的漯	
漶	漫漶	的漶	
潋	潋	滟的潋	
潴	潴	留的潴	
漪	漪	澜的漪	
漉	漉	网的漉	
漩	漩	涡的漩	
澉	澉	浦的澉	
澍	澍	与的澍	
澌	澌	灭的澌	
潸	潸	然的潸	
潲	潲	雨的潲	
潼	潼	关的潼	
潺	潺	潺	的潺	
濑	水濑	的濑	
濉	濉	河的濉	
澧	澧	水的澧	
澶	澶	渊的澶	
濂	濂	江的濂	
濡	濡	湿的濡	
濮	濮	阳的濮	
濞	漾濞	的濞	
濠	濠	水的濠	
濯	洗濯	的濯	
瀚	浩瀚	的瀚	
瀣	水气的瀣	
瀛	瀛	台的瀛	
瀹	瀹	输的瀹	
瀵	瀵	泉的瀵	
灏	大水的灏	
灞	水灞	的灞	
宀	盖儿的宀	
宄	奸宄	的宄	
宕	延宕	的宕	
宓	宓	静的宓	
宥	宽宥	的宥	
宸	宸	章的宸	
甯	甯	可的甯	
骞	骞	举的骞	
搴	搴	旗的搴	
寤	醒寤	的寤	
寮	茅寮	的寮	
褰	褰	裳的褰	
寰	寰	球的寰	
蹇	蹇	跛的蹇	
謇	口謇	的謇	
辶	辶	之的辶	
迓	迎迓	的迓	
迕	违迕	的迕	
迥	迥	然的迥	
迮	走迮	的迮	
迤	逶迤	的迤	
迩	遐迩	的迩	
迦	释迦	的迦	
迳	迳	直的迳	
迨	迨	到的迨	
逅	邂逅	的逅	
逄	姓逄	的逄	
逋	逋	峭的逋	
逦	迤逦	的逦	
逑	逑	配的逑	
逍	逍	遥的逍	
逖	逖	远的逖	
逡	逡	巡的逡	
逵	逵	路的逵	
逶	逶	移的逶	
逭	逭	逃的逭	
逯	姓逯	的逯	
遄	遄	返的遄	
遑	遑	遑	的遑	
遒	遒	劲的遒	
遐	遐	想的遐	
遨	遨	游的遨	
遘	相遇的遘	
遢	邋遢	的遢	
遛	逗遛	的遛	
暹	暹	罗的暹	
遴	遴	选的遴	
遽	遽	然的遽	
邂	邂	逅的邂	
邈	邈	远的邈	
邃	经邃	的邃	
邋	邋	遢的邋	
彐	字头的彐	
彗	彗	星的彗	
彖	彖	辞的彖	
彘	彘	猪的彘	
尻	尻	骨的尻	
咫	咫	尺的咫	
屐	屐	履的屐	
屙	屙	屎的屙	
屣	敝屣	的屣	
屦	屦	鞋的屦	
羼	羼	杂的羼	
弪	弧弪	的弪	
弩	弓弩	的弩	
弭	弭	只的弭	
艴	艴	然的艴	
弼	弼	助的弼	
鬻	鬻	歌的鬻	
屮	字头的屮	
妁	媒妁	的妁	
妃	王妃	的妃	
妍	美丽的妍	
妩	妩	媚的妩	
妪	老妪	的妪	
妣	考妣	的妣	
妗	女妗	的妗	
姊	姊	妹的姊	
妫	妫	水的妫	
妞	小妞	的妞	
妤	婕妤	的妤	
姒	娣姒	的姒	
妲	妲	己的妲	
妯	妯	娌的妯	
姗	姗	姗	的姗	
妾	妻妾	的妾	
娅	姻娅	的娅	
娆	妖娆	的娆	
姝	姝	美的姝	
娈	娈	美的娈	
姣	姣	好的姣	
姘	姘	头的姘	
姹	姹	紫的姹	
娌	妯娌	的娌	
娉	娉	婷的娉	
娲	女娲	的娲	
娴	娴	静的娴	
娑	婆娑	的娑	
娣	娣	姒的娣	
娓	娓	娓	的娓	
婀	婀	挪的婀	
婧	女婧	的婧	
婊	婊	子的婊	
婕	婕	女的婕	
娼	娼	妓的娼	
婢	婢	女的婢	
婵	婵	娟的婵	
胬	胬	肉的胬	
媪	女媪	的媪	
媛	婵媛	的媛	
婷	婷	婷	的婷	
婺	婺	江的婺	
媾	媾	和的媾	
嫫	嫫	母的嫫	
媲	媲	美的媲	
嫒	女嫒	的嫒	
嫔	嫔	嫁的嫔	
媸	媸	丑的媸	
嫠	嫠	妇的嫠	
嫣	嫣	然的嫣	
嫱	妃嫱	的嫱	
嫖	嫖	妓的嫖	
嫦	嫦	娥的嫦	
嫘	嫘	祖的嫘	
嫜	姑嫜	的嫜	
嬉	嬉	皮的嬉	
嬗	嬗	变的嬗	
嬖	嬖	爱的嬖	
嬲	嬲	弄的嬲	
嬷	奶妈的嬷	
孀	孀	妇的孀	
尕	小尕	的尕	
尜	小尜	的尜	
孚	孚	望的孚	
孥	孥	子的孥	
孳	孳	声的孳	
孑	孑	觉的孑	
孓	孑孓	的孓	
孢	孢	子的孢	
驵	马驵	的驵	
驷	驷	马的驷	
驸	驸	马的驸	
驺	马驺	的驺	
驿	驿	站的驿	
驽	驽	马的驽	
骁	骁	骑的骁	
骅	骅	骝的骅	
骈	骈	体的骈	
骊	骊	马的骊	
骐	马骐	的骐	
骒	骒	马的骒	
骓	骓	马的骓	
骖	骖	马的骖	
骘	评骘	的骘	
骛	骛	远的骛	
骜	马骜	的骜	
骝	马骝	的骝	
骟	骟	马的骟	
骢	马骢	的骢	
骣	马骣	的骣	
骥	马骥	的骥	
骧	马骧	的骧	
纟	丝旁的纟	
纡	绕弯的纡	
纣	纣	王的纣	
纨	纨	绔的纨	
纩	丝纩	的纩	
纭	纷纭	的纭	
纰	纰	漏的纰	
纾	纾	难的纾	
绀	绀	青的绀	
绁	缧绁	的绁	
绂	丝绂	的绂	
绉	绉	纱的绉	
绋	大绳的绋	
绌	补绌	的绌	
绐	欺绐	的绐	
绔	纨绔	的绔	
绗	绗	被的绗	
绛	绛	紫的绛	
绠	绳绠	的绠	
绡	丝绡	的绡	
绨	绨	袍的绨	
绫	绫	罗的绫	
绮	绮	丽的绮	
绯	绯	闻的绯	
绱	绱	鞋的绱	
绲	绲	边的绲	
缍	穗垂的缍	
绶	绶	带的绶	
绺	一绺	的绺	
绻	缱绻	的绻	
绾	绾	扣的绾	
缁	缁	黑的缁	
缂	缂	丝的缂	
缃	缃	素的缃	
缇	橘红的缇	
缈	缥缈	的缈	
缋	丝缋	的缋	
缌	缌	布的缌	
缑	缑	氏的缑	
缒	缒	下的缒	
缗	缗	绳的缗	
缙	缙	绅的缙	
缜	缜	密的缜	
缛	缛	礼的缛	
缟	缟	素的缟	
缡	结缡	的缡	
缢	自缢	的缢	
缣	缣	绢的缣	
缤	缤	纷的缤	
缥	缥	缈的缥	
缦	丝缦	的缦	
缧	缧	绁的缧	
缫	缫	丝的缫	
缬	缬	草的缬	
缭	缭	绕的缭	
缯	丝缯	的缯	
缰	缰	绳的缰	
缱	缱	绻的缱	
缳	缳	绳的缳	
缵	缵	承的缵	
幺	幺	妹的幺	
畿	京畿	的畿	
巛	山巛	的巛	
甾	甾	类的甾	
邕	邕	江的邕	
玎	玎	当的玎	
玑	珠玑	的玑	
玮	玮	奇的玮	
玟	王玟	的玟	
珏	珏	玉的珏	
珂	玉珂	的珂	
珑	玲珑	的珑	
玷	玷	辱的玷	
玳	玳	瑁的玳	
珀	琥珀	的珀	
珉	育珉	的珉	
珈	珈	玉的珈	
珥	日珥	的珥	
珙	珙	育的珙	
顼	姓顼	的顼	
琊	琅琊	的琊	
珧	江珧	的珧	
珞	珞	巴的珞	
玺	玉玺	的玺	
琏	琏	器的琏	
琪	琪	美的琪	
瑛	瑛	玉的瑛	
琦	琦	玉的琦	
琥	琥	珀的琥	
琨	琨	玉的琨	
琰	琰	玉的琰	
琮	玉琮	的琮	
琬	琬	玉的琬	
琛	珍宝的琛	
琚	琚	玉的琚	
瑁	玳瑁	的瑁	
瑜	美玉的瑜	
瑗	瑗	环的瑗	
瑕	无瑕	的瑕	
瑙	玛瑙	的瑙	
瑷	瑷	珲的瑷	
瑭	玉瑭	的瑭	
瑾	秋瑾	的瑾	
璜	装璜	的璜	
璎	璎	珞的璎	
璀	璀	璨的璀	
璁	璁	石的璁	
璇	璇	玉的璇	
璋	璋	玉的璋	
璞	璞	玉的璞	
璨	璨	玉的璨	
璩	璩	玉的璩	
璐	璐	玉的璐	
璧	完璧	的璧	
瓒	玉瓒	的瓒	
璺	璺	裂的璺	
韪	不韪	的韪	
韫	韫	含的韫	
韬	韬	略的韬	
杌	杌	凳的杌	
杓	木勺的杓	
杞	杞	人的杞	
杈	树杈	的杈	
杩	杩	头的杩	
枥	枥	槽的枥	
枇	枇	啪的枇	
杪	杪	颠的杪	
杳	杳	渺的杳	
枘	枘	凿的枘	
枧	香枧	的枧	
杵	杵	臼的杵	
枨	枨	触的枨	
枭	枭	雄的枭	
枋	枋	子的枋	
杷	皮杷	的杷	
杼	杼	轴的杼	
柰	柰	子的柰	
栉	栉	比的栉	
柘	柘	树的柘	
栊	帘栊	的栊	
柩	灵柩	的柩	
枰	棋枰	的枰	
栌	黄栌	的栌	
柙	柙	笼的柙	
枵	枵	薄的枵	
柚	柚	木的柚	
枳	乔木的枳	
柝	更梆的柝	
栀	栀	子的栀	
柃	木柃	的柃	
枸	枸	杞的枸	
柢	根柢	的柢	
柽	柽	柳的柽	
栲	栲	树的栲	
栳	栲栳	的栳	
桠	桠	杈的桠	
桡	桡	骨的桡	
桎	桎	梏的桎	
桢	桢	干的桢	
桄	桄	榔的桄	
桤	桤	木的桤	
梃	木梃	的梃	
桕	木桕	的桕	
桦	桦	木的桦	
桁	桁	架的桁	
桀	夏桀	的桀	
栾	栾	树的栾	
桊	桊	儿的桊	
桉	桉	木的桉	
栩	栩	栩	的栩	
梵	梵	语的梵	
梏	桎梏	的梏	
桴	木桴	的桴	
桷	船桷	的桷	
梓	梓	树的梓	
桫	桫	椤的桫	
棂	窗棂	的棂	
楮	楮	树的楮	
棼	纷乱的棼	
椟	木椟	的椟	
椠	宋椠	的椠	
棹	棹	桨的棹	
椤	桫椤	的椤	
棰	棰	棍的棰	
椋	欧椋	的椋	
椁	棺椁	的椁	
楗	木楗	的楗	
棣	堂棣	的棣	
椐	毛椐	的椐	
楱	木楱	的楱	
楠	楠	木的楠	
楝	楝	树的楝	
榄	橄榄	的榄	
楫	舟楫	的楫	
榀	一榀	的榀	
榘	榘	齿的榘	
楸	楸	树的楸	
椴	椴	木的椴	
槌	棒槌	的槌	
榇	榇	棺的榇	
榈	棕榈	的榈	
槎	槎	服的槎	
榉	木榉	的榉	
楦	鞋楦	的楦	
楣	门楣	的楣	
楹	楹	联的楹	
榛	榛	子的榛	
榧	香榧	的榧	
榻	下榻	的榻	
榫	榫	头的榫	
榭	水榭	的榭	
槔	桔槔	的槔	
榱	榱	椽的榱	
槁	枯槁	的槁	
槊	槊	矛的槊	
榕	榕	树的榕	
槠	槠	树的槠	
榍	木屑的榍	
槿	木槿	的槿	
樯	风樯	的樯	
槭	槭	树的槭	
樗	樗	蒲的樗	
樘	门樘	的樘	
橥	橥	装的橥	
槲	槲	树的槲	
橄	橄	榄的橄	
樾	木樾	的樾	
檠	檠	架的檠	
橐	橐	驼的橐	
橛	木橛	的橛	
樵	樵	夫的樵	
檎	林檎	的檎	
橹	摇橹	的橹	
樽	酒樽	的樽	
樨	木樨	的樨	
橘	橘	子的橘	
橼	香橼	的橼	
檑	檑	木的檑	
檐	房檐	的檐	
檩	檩	条的檩	
檗	黄檗	的檗	
檫	木檫	的檫	
猷	鸿猷	的猷	
獒	獒	犬的獒	
殁	病殁	的殁	
殂	死殂	的殂	
殇	殇	亡的殇	
殄	暴殄	的殄	
殒	殒	灭的殒	
殓	入殓	的殓	
殍	饿殍	的殍	
殚	殚	力的殚	
殛	雷殛	的殛	
殡	殡	葬的殡	
殪	殪	杀的殪	
轫	发轫	的轫	
轭	轭	具的轭	
轱	轱	辘的轱	
轲	孟轲	的轲	
轳	辘轳	的轳	
轵	轵	城的轵	
轶	轶	事的轶	
轸	轸	念的轸	
轷	姓轷	的轷	
轹	欺轹	的轹	
轺	轺	车的轺	
轼	车轼	的轼	
轾	轩轾	的轾	
辁	辁	才的辁	
辂	辂	车的辂	
辄	动辄	的辄	
辇	车辇	的辇	
辋	车辋	的辋	
辍	辍	学的辍	
辎	辎	重的辎	
辏	辐辏	的辏	
辘	轱辘	的辘	
辚	车辚	的辚	
軎	车軎	的軎	
戋	系戋	的戋	
戗	戗	风的戗	
戛	戛	然的戛	
戟	戟	枪的戟	
戢	戢	怒的戢	
戡	戡	乱的戡	
戥	戥	子的戥	
戤	戤	利的戤	
戬	戬	除的戬	
臧	姓臧	的臧	
瓯	瓯	江的瓯	
瓴	建瓴	的瓴	
瓿	瓿	瓮的瓿	
甏	甏	器的甏	
甑	甑	子的甑	
甓	甓	砖的甓	
攴	姓攴	的攴	
旮	旮	旯的旮	
旯	旮旯	的旯	
旰	旰	晚的旰	
昊	昊	天的昊	
昙	昙	花的昙	
杲	杲	日的杲	
昃	日昃	的昃	
昕	日昕	的昕	
昀	日昀	的昀	
曷	疑问的曷	
昝	姓昝	的昝	
昴	昴	宿的昴	
昱	昱	光的昱	
昶	舒昶	的昶	
昵	亲昵	的昵	
耆	耆	老的耆	
晟	晟	明的晟	
晔	晔	美的晔	
晁	晁	盖的晁	
晏	晏	起的晏	
晖	晖	映的晖	
晡	晡	时的晡	
晗	无晗	的晗	
晷	日晷	的晷	
暄	寒暄	的暄	
暌	暌	违的暌	
暧	暧	昧的暧	
暝	日落的暝	
暾	朝暾	的暾	
曛	夕曛	的曛	
曜	曜	日的曜	
曦	晨曦	的曦	
曩	曩	日的曩	
贳	借款的贳	
贶	厚贶	的贶	
贻	贻	害的贻	
贽	贽	见的贽	
赀	赀	计的赀	
赅	赅	扩的赅	
赆	赆	仪的赆	
赈	赈	灾的赈	
赉	赏赉	的赉	
赇	赇	贿的赇	
赍	赍	制的赍	
赕	赕	佛的赕	
赙	赙	赠的赙	
觇	觇	标的觇	
觊	觊	望的觊	
觋	巫觋	的觋	
觌	觌	面的觌	
觎	觊觎	的觎	
觏	见觏	的觏	
觐	觐	见的觐	
觑	觑	眼的觑	
牮	打牮	的牮	
犟	犟	嘴的犟	
牝	牝	牛的牝	
牦	牦	牛的牦	
牯	牯	牛的牯	
牾	抵牾	的牾	
牿	牛牿	的牿	
犄	犄	角的犄	
犋	牛犋	的犋	
犏	犏	牛的犏	
犒	犒	劳的犒	
挈	挈	带的挈	
掰	掰	开的掰	
搿	搿	合的搿	
擘	巨擘	的擘	
耄	耄	耋的耄	
毪	毪	子的毪	
毳	毳	毛的毳	
毽	踢毽	的毽	
毵	毵	毵	的毵	
毹	氍毹	的毹	
氅	大氅	的氅	
氇	氆氇	的氇	
氆	氆	氇的氆	
氍	氍	毹的氍	
氕	气氕	的氕	
氘	氘	气的氘	
氙	氙	气的氙	
氚	氢氚	的氚	
氡	氡	气的氡	
氩	氩	气的氩	
氤	氤	氲的氤	
氪	气氪	的氪	
氲	氤氲	的氲	
攵	文旁的攵	
敕	敕	封的敕	
敫	敫	家的敫	
牍	案牍	的牍	
牒	通牒	的牒	
牖	牖	窗的牖	
爰	何爰	的爰	
虢	州虢	的虢	
刖	刖	刑的刖	
肟	肟	类的肟	
肜	肜	祭的肜	
肓	膏肓	的肓	
肼	肼	物的肼	
朊	朊	蛋的朊	
肽	肽	级的肽	
肱	肱	骨的肱	
肫	鸡肫	的肫	
肭	腽肭	的肭	
肴	菜肴	的肴	
肷	肷	窝的肷	
胧	朦胧	的胧	
胨	肉胨	的胨	
胩	胩	类的胩	
胪	胪	列的胪	
胛	胛	骨的胛	
胂	胂	物的胂	
胄	甲胄	的胄	
胙	胙	肉的胙	
胍	胍	物的胍	
胗	鸡胗	的胗	
朐	临朐	的朐	
胝	胼胝	的胝	
胫	胫	骨的胫	
胱	膀胱	的胱	
胴	胴	体的胴	
胭	胭	脂的胭	
脍	脍	炙的脍	
脎	脎	类的脎	
胲	胲	物的胲	
胼	胼	胝的胼	
朕	朕	我的朕	
脒	脒	类的脒	
豚	豚	鼠的豚	
脶	纹脶	的脶	
脞	丛脞	的脞	
脬	尿脬	的脬	
脘	胃脘	的脘	
脲	尿素的脲	
腈	腈	纶的腈	
腌	淹菜的腌	
腓	腓	骨的腓	
腴	高腴	的腴	
腙	腙	类的腙	
腚	臀腚	的腚	
腱	肌腱	的腱	
腠	腠	理的腠	
腩	牛腩	的腩	
腼	腼	腆的腼	
腽	腽	肭的腽	
腭	硬腭	的腭	
腧	腧	穴的腧	
塍	塍	梗的塍	
媵	媵	妾的媵	
膈	膈	膜的膈	
膂	膂	力的膂	
膑	髌骨的膑	
滕	姓滕	的滕	
膣	膣	部的膣	
膪	囊膪	的膪	
臌	臌	胀的臌	
朦	朦	胧的朦	
臊	害臊	的臊	
膻	膻	味的膻	
臁	臁	骨的臁	
膦	化膦	的膦	
欤	疑欤	的欤	
欷	抽搭的欷	
歃	歃	血的歃	
歆	歆	慕的歆	
飑	飑	风的飑	
飒	飒	爽的飒	
飓	飓	风的飓	
飕	飕	干的飕	
飙	狂飙	的飙	
飚	狂飙的飚	
殳	姓殳	的殳	
彀	彀	中的彀	
毂	毂	轮的毂	
觳	觳	觫的觳	
斐	斐	然的斐	
齑	齑	粉的齑	
斓	斑斓	的斓	
於	方於	的於	
旆	旆	旗的旆	
旄	旄	旗的旄	
旃	勉旃	的旃	
旌	旌	旗的旌	
旎	旖旎	的旎	
旒	旒	带的旒	
旖	旖	旎的旖	
炀	火炀	的炀	
炜	炜	明的炜	
炖	炖	肉的炖	
炝	炝	锅的炝	
炻	炻	器的炻	
烀	烀	饭的烀	
炷	一炷	的炷	
炫	炫	耀的炫	
炱	煤炱	的炱	
烨	烨	烨	的烨	
烊	打烊	的烊	
焐	焐	热的焐	
焓	热焓	的焓	
焖	火焖	的焖	
焱	焱	焱	的焱	
煳	烤煳	的煳	
煜	煜	亮的煜	
煨	煨	肉的煨	
煅	煅	烧的煅	
煲	火煲	的煲	
煊	煊	赫的煊	
煸	煸	炒的煸	
煺	煺	火的煺	
熘	熘	炒的熘	
熳	烂熳	的熳	
熵	热熵	的熵	
熠	熠	明的熠	
燠	燠	热的燠	
燔	燔	烤的燔	
燧	燧	石的燧	
燹	兵燹	的燹	
爝	爝	火的爝	
爨	分爨	的爨	
灬	点底的灬	
煦	和煦	的煦	
熹	株熹	的熹	
戾	罪戾	的戾	
戽	戽	斗的戽	
扃	扃	闭的扃	
扈	跋扈	的扈	
扉	扉	页的扉	
礻	字边的礻	
祀	祀	祖的祀	
祆	祆	教的祆	
祉	福祉	的祉	
祛	祛	除的祛	
祜	祜	福的祜	
祓	祓	除的祓	
祚	帝祚	的祚	
祗	祗	恭的祗	
祠	祠	堂的祠	
祯	祯	祥的祯	
祧	祧	妙的祧	
祺	祺	祥的祺	
禊	禊	祭的禊	
禚	姓禚	的禚	
禧	贺禧	的禧	
禳	禳	解的禳	
忑	忐忑	的忑	
忐	忐	忑的忐	
怼	怨怼	的怼	
恝	恝	置的恝	
恚	恚	恨的恚	
恧	惭愧的恧	
恙	无恙	的恙	
恣	恣	抑的恣	
悫	诚悫	的悫	
愆	愆	尤的愆	
愍	愍	忧的愍	
憩	小憩	的憩	
憝	大憝	的憝	
懋	勤懋	的懋	
懑	愤懑	的懑	
戆	戆	头的戆	
肀	字头的肀	
聿	聿	明的聿	
泶	泶	泉的泶	
淼	浩淼	的淼	
矶	石矶	的矶	
矸	石矸	的矸	
砀	砀	山的砀	
砗	砗	磲的砗	
砘	砘	子的砘	
砑	砑	光的砑	
斫	斧斫	的斫	
砭	针砭	的砭	
砜	物砜	的砜	
砝	砝	码的砝	
砹	时砹	的砹	
砺	底砺	的砺	
砻	砻	糠的砻	
砟	焦砟	的砟	
砼	时砼	的砼	
砥	砥	柱的砥	
砬	砬	子的砬	
砣	砣	子的砣	
砩	砩	石的砩	
硎	硎	磨的硎	
硭	硭	硝的硭	
硖	硖	石的硖	
硗	硗	薄的硗	
砦	鹿砦	的砦	
硐	石洞的硐	
硇	硇	砂的硇	
硪	实硪	的硪	
碛	碛	滩的碛	
碓	碓	房的碓	
碚	北碚	的碚	
碇	石碇	的碇	
碜	牙碜	的碜	
碡	碌碡	的碡	
碣	石碣	的碣	
碲	碲	物的碲	
碹	碹	拱的碹	
碥	碥	石的碥	
磔	磔	刑的磔	
磙	石磙	的磙	
磉	磉	石的磉	
磬	编磬	的磬	
磲	车磲	的磲	
礅	石礅	的礅	
磴	石磴	的磴	
礓	砂礓	的礓	
礤	礤	床的礤	
礞	礞	石的礞	
礴	旁礴	的礴	
龛	佛龛	的龛	
黹	针黹	的黹	
黻	黻	花的黻	
黼	黼	花的黼	
盱	盱	衡的盱	
眄	眄	视的眄	
眍	目眍	的眍	
盹	打盹	的盹	
眇	眇	眼的眇	
眈	眈	眈	的眈	
眚	木眚	的眚	
眢	眢	井的眢	
眙	盱眙	的眙	
眭	姓眭	的眭	
眦	目眦	的眦	
眵	眼眵	的眵	
眸	眸	子的眸	
睐	目睐	的睐	
睑	睑	毛的睑	
睇	睇	看的睇	
睃	睃	视的睃	
睚	睚	眦的睚	
睨	睨	视的睨	
睢	睢	现的睢	
睥	睥	睨的睥	
睿	睿	智的睿	
瞍	瞍	盲的瞍	
睽	睽	睽	的睽	
瞀	昏瞀	的瞀	
瞌	瞌	睡的瞌	
瞑	瞑	目的瞑	
瞟	瞟	眼的瞟	
瞠	瞠	目的瞠	
瞰	鸟瞰	的瞰	
瞵	瞵	视的瞵	
瞽	瞽	忙的瞽	
畀	田畀	的畀	
畎	畎	亩的畎	
畋	畋	猎的畋	
畈	畈	田的畈	
畛	畛	域的畛	
畲	畲	族的畲	
畹	畹	町的畹	
疃	王疃	的疃	
罘	芝罘	的罘	
罡	罡	风的罡	
罟	罟	网的罟	
詈	骂詈	的詈	
罨	冷罨	的罨	
罴	熊罴	的罴	
罱	罱	泥的罱	
罹	罹	难的罹	
羁	羁	绊的羁	
罾	罾	网的罾	
盍	盍	然的盍	
盥	盥	洗的盥	
蠲	蠲	免的蠲	
钅	字旁的钅	
钆	金钆	的钆	
钇	钇	铁的钇	
钋	金钋	的钋	
钊	大钊	的钊	
钌	金钌	的钌	
钍	金钍	的钍	
钏	金钏	的钏	
钐	金钐	的钐	
钔	金钔	的钔	
钗	金钗	的钗	
钕	金钕	的钕	
钚	金钚	的钚	
钛	金钛	的钛	
钜	钜	大的钜	
钣	金钣	的钣	
钤	钤	印的钤	
钫	金钫	的钫	
钪	金钪	的钪	
钭	姓钭	的钭	
钬	金钬	的钬	
钰	宝钰	的钰	
钲	钲	亮的钲	
钴	钴	刚的钴	
钶	金钶	的钶	
钷	金钷	的钷	
钸	金版的钸	
钹	钹	镲的钹	
钺	金钺	的钺	
钼	钼	钢的钼	
钽	金钽	的钽	
铄	铄	金的铄	
铈	金铈	的铈	
铉	铉	器的铉	
铋	金铋	的铋	
铌	金铌	的铌	
铍	金铍	的铍	
铎	金铎	的铎	
铐	手铐	的铐	
铑	铂铑	的铑	
铒	金铒	的铒	
铕	金铕	的铕	
铖	金铖	的铖	
铗	剑铗	的铗	
铙	钹镲的铙	
铘	镆铘	的铘	
铞	钌铞	的铞	
铟	素铟	的铟	
铠	铠	甲的铠	
铢	滋铢	的铢	
铥	金铥	的铥	
铧	犁铧	的铧	
铨	铨	叙的铨	
铪	金铪	的铪	
铩	铩	毛的铩	
铮	铮	铮	的铮	
铯	金铯	的铯	
铳	铳	子的铳	
铴	铴	锣的铴	
铵	金铵	的铵	
铷	金铷	的铷	
铹	金铹	的铹	
铼	金铼	的铼	
铽	金铽	的铽	
铿	铿	锵的铿	
锃	锃	亮的锃	
锂	金锂	的锂	
锆	锆	金的锆	
锇	金锇	的锇	
锉	锉	刀的锉	
锊	金锊	的锊	
锍	杂锍	的锍	
锎	金锎	的锎	
锏	锏	条的锏	
锒	锒	当的锒	
锓	锓	版的锓	
锔	锔	盆的锔	
锕	金锕	的锕	
锖	金锖	的锖	
锘	金锘	的锘	
锛	锛	子的锛	
锝	金锝	的锝	
锞	金锞	的锞	
锟	锟	吾的锟	
锢	进锢	的锢	
锪	金锪	的锪	
锫	金锫	的锫	
锩	锩	刃的锩	
锬	锬	矛的锬	
锱	锱	铢的锱	
锲	雕锲	的锲	
锴	好铁的锴	
锶	金锶	的锶	
锷	锷	刀的锷	
锸	铁锸	的锸	
锼	锼	子的锼	
锾	罚锾	的锾	
锿	金锿	的锿	
镂	镂	空的镂	
锵	锵	锵	的锵	
镄	金镄	的镄	
镅	金镅	的镅	
镆	镆	铘的镆	
镉	金镉	的镉	
镌	镌	刻的镌	
镎	金镎	的镎	
镏	镏	金的镏	
镒	镒	虫的镒	
镓	金镓	的镓	
镔	镔	铁的镔	
镖	飞镖	的镖	
镗	镗	床的镗	
镘	金镘	的镘	
镙	罗金的镙	
镛	大镛	的镛	
镞	箭镞	的镞	
镟	镟	床的镟	
镝	金镝	的镝	
镢	镢	头的镢	
镤	金镤	的镤	
镥	金镥	的镥	
镦	冷镦	的镦	
镧	金镧	的镧	
镨	金镨	的镨	
镩	镩	子的镩	
镪	镪	水的镪	
镫	马镫	的镫	
镬	顶镬	的镬	
镯	手镯	的镯	
镱	镱	素的镱	
镲	小镲	的镲	
镳	扬镳	的镳	
锺	锺	爱的锺	
矧	矧	况的矧	
矬	矬	子的矬	
雉	雉	机的雉	
秕	合秕	的秕	
秭	秭	归的秭	
秣	秣	马的秣	
秫	秫	秸的秫	
稆	稆	生的稆	
嵇	嵇	康的嵇	
稃	壳稃	的稃	
稂	稂	草的稂	
稞	青稞	的稞	
稔	稔	知的稔	
稹	合稹	的稹	
稷	社稷	的稷	
穑	稼穑	的穑	
黏	黏	土的黏	
馥	馥	香的馥	
穰	核穰	的穰	
皈	皈	依的皈	
皎	皎	洁的皎	
皓	皓	首的皓	
皙	白皙	的皙	
皤	白皤	的皤	
瓞	瓜瓞	的瓞	
瓠	瓠	子的瓠	
甬	甬	道的甬	
鸠	斑鸠	的鸠	
鸢	鸢	尾的鸢	
鸨	老鸨	的鸨	
鸩	饮鸩	的鸩	
鸪	鹧鸪	的鸪	
鸫	鸫	鸟的鸫	
鸬	鸬	鹚的鸬	
鸲	鸲	鹆的鸲	
鸱	鸱	吻的鸱	
鸶	鹭鸶	的鸶	
鸸	鸸	鹋的鸸	
鸷	鸷	鸟的鸷	
鸹	老鸹	的鸹	
鸺	鸱鸺	的鸺	
鸾	鸾	凤的鸾	
鹁	鹁	鸪的鹁	
鹂	黄鹂	的鹂	
鹆	鸲鹆	的鹆	
鹇	鸟鹇	的鹇	
鹈	鹈	鹕的鹈	
鹉	鹦鹉	的鹉	
鹋	鹋	疗的鹋	
鹌	鹌	鹑的鹌	
鹎	鹎	鸟的鹎	
鹑	鹌鹑	的鹑	
鹕	鹈鹕	的鹕	
鹗	鹗	鸟的鹗	
鹚	鸬鹚	的鹚	
鹛	鹛	鸟的鹛	
鹜	鹜	列的鹜	
鹞	鹞	鹰的鹞	
鹣	鹣	鹣	的鹣	
鹦	鹦	鹉的鹦	
鹧	鹧	鸪的鹧	
鹨	鸟鹨	的鹨	
鹩	鹪鹩	的鹩	
鹪	鹪	鹩的鹪	
鹫	鹫	鹰的鹫	
鹬	鹬	蚌的鹬	
鹱	鹱	鸟的鹱	
鹭	鹭	鸶的鹭	
鹳	鸟鹳	的鹳	
疒	字头的疒	
疔	疔	疮的疔	
疖	疖	子的疖	
疠	瘟疫的疠	
疝	疝	气的疝	
疬	病疬	的疬	
疣	瘊子的疣	
疳	疳	病的疳	
疴	沉疴	的疴	
痄	痄	腮的痄	
疱	疱	疹的疱	
疰	疰	夏的疰	
痃	病痃	的痃	
痂	结痂	的痂	
痖	聋痖	的痖	
痍	疮痍	的痍	
痣	黑痣	的痣	
痨	痨	病的痨	
痦	痦	子的痦	
痤	痤	疮的痤	
痫	癫痫	的痫	
痧	病痧	的痧	
瘃	瘃	疮的瘃	
痱	痱	子的痱	
痼	痼	级的痼	
痿	下痿	的痿	
瘐	瘐	死的瘐	
瘀	瘀	血的瘀	
瘅	病瘅	的瘅	
瘌	瘌	痢的瘌	
瘗	瘗	葬的瘗	
瘊	病瘊	的瘊	
瘘	瘘	管的瘘	
瘕	瘕	病的瘕	
瘙	瘙	痒的瘙	
瘛	瘛	病的瘛	
瘼	民瘼	的瘼	
瘢	瘢	痕的瘢	
瘠	贫瘠	的瘠	
癀	癀	病的癀	
瘭	瘭	疽的瘭	
瘰	瘰	疬的瘰	
瘿	瘿	流的瘿	
瘵	瘵	病的瘵	
癃	癃	闭的癃	
瘾	烟瘾	的瘾	
瘳	病愈的瘳	
癍	癍	病的癍	
癞	癞	皮的癞	
癔	癔	病的癔	
癜	白癜	的癜	
癖	癖	号的癖	
癫	疯癫	的癫	
癯	清癯	的癯	
翊	翊	代的翊	
竦	力竦	的竦	
穸	窀穸	的穸	
穹	穹	窿的穹	
窀	窀	穸的窀	
窆	埋葬的窆	
窈	窈	窕的窈	
窕	窈窕	的窕	
窦	鼻窦	的窦	
窠	窠	臼的窠	
窬	穿窬	的窬	
窭	窭	穷的窭	
窳	窳	败的窳	
衤	衤	字的衤	
衩	裤衩	的衩	
衲	衲	补的衲	
衽	衽	席的衽	
衿	衿	代的衿	
袂	连袂	的袂	
袢	袷袢	的袢	
裆	裤裆	的裆	
袼	袼	褙的袼	
裉	一裉	的裉	
裢	褡裢	的裢	
裎	裎	裸的裎	
裣	裣	衽的裣	
裥	衣裥	的裥	
裱	裱	糊的裱	
裾	衣裾	的裾	
裰	补裰	的裰	
褡	褡	连的褡	
褙	裱褙	的褙	
褓	襁褓	的褓	
褛	褴褛	的褛	
褊	褊	狭的褊	
褴	褴	褛的褴	
褫	褫	夺的褫	
褶	褶	子的褶	
襁	襁	褓的襁	
襦	衣襦	的襦	
襻	纽襻	的襻	
疋	布疋	的疋	
胥	胥	吏的胥	
皲	杆裂的皲	
皴	皮皴	的皴	
耒	耒	耜的耒	
耔	耔	土的耔	
耖	耖	地的耖	
耜	耜	具的耜	
耠	耠	地的耠	
耢	耢	地的耢	
耥	耥	耙的耥	
耦	耦	合的耦	
耧	耧	地的耧	
耩	耩	地的耩	
耨	耨	草的耨	
耱	耱	地的耱	
耋	耄耋	的耋	
耵	耵	聍的耵	
聃	老聃	的聃	
聆	聆	听的聆	
聍	叮聍	的聍	
聒	聒	造的聒	
聩	聋聩	的聩	
聱	聱	牙的聱	
顸	颟顸	的顸	
颀	颀	长的颀	
颃	颉颃	的颃	
颍	颍	河的颍	
颏	下颏	的颏	
颔	颔	首的颔	
颚	上颚	的颚	
颛	颛	孙的颛	
颞	颞	骨的颞	
颟	颟	顸的颟	
颡	颡	额的颡	
颢	颢	亮的颢	
颥	颥	骨的颥	
颦	颦	蹙的颦	
虍	字头的虍	
虔	虔	诚的虔	
虬	虬	髯的虬	
虮	虫虮	的虮	
虿	虫虿	的虿	
虺	虺	虺	的虺	
虼	虫虼	的虼	
虻	牛虻	的虻	
蚨	青蚨	的蚨	
蚍	蚍	蜉的蚍	
蚋	蚋	虫的蚋	
蚬	蚬	子的蚬	
蚧	蛤蚧	的蚧	
蚣	蜈蚣	的蚣	
蚪	蝌蚪	的蚪	
蚓	蚯蚓	的蚓	
蚩	蚩	尤的蚩	
蚶	蚶	子的蚶	
蛄	蝼蛄	的蛄	
蛎	牡蛎	的蛎	
蚰	蚰	蜒的蚰	
蚺	蚺	蛇的蚺	
蚱	蚱	蜢的蚱	
蚯	蚯	蚓的蚯	
蛉	白蛉	的蛉	
蛏	蛏	子的蛏	
蚴	尾蚴	的蚴	
蛩	虫蛩	的蛩	
蛱	蛱	蝶的蛱	
蛲	蛲	虫的蛲	
蛭	水蛭	的蛭	
蛳	螺蛳	的蛳	
蛐	蛐	蛐	的蛐	
蜓	蜻蜓	的蜓	
蛞	蛞	蝓的蛞	
蛴	蛴	螬的蛴	
蛟	蛟	龙的蛟	
蛘	米蛘	的蛘	
蛑	由蛑	的蛑	
蜃	蜃	楼的蜃	
蜇	海蜇	的蜇	
蜈	蜈	蚣的蜈	
蜊	蛤蜊	的蜊	
蜍	蟾蜍	的蜍	
蜉	皮蜉	的蜉	
蜣	蜣	螂的蜣	
蜻	蜻	蜓的蜻	
蜞	蟛蜞	的蜞	
蜥	蜥	蜴的蜥	
蜮	鬼蜮	的蜮	
蜚	蜚	声的蜚	
蜾	蜾	蠃的蜾	
蝈	蝈	蝈	的蝈	
蜴	蜥蜴	的蜴	
蜱	蜱	虫的蜱	
蜩	蜩	蝉的蜩	
蜷	蜷	缩的蜷	
蜿	蜿	蜒的蜿	
螂	螳螂	的螂	
蜢	蚱蜢	的蜢	
蝽	蝽	象的蝽	
蝾	蝾	螈的蝾	
蝻	蝗蝻	的蝻	
蝠	蝙蝠	的蝠	
蝰	蝰	蛇的蝰	
蝌	蝌	蚪的蝌	
蝮	蝮	蛇的蝮	
螋	蠼螋	的螋	
蝓	蛞蝓	的蝓	
蝣	蜉蝣	的蝣	
蝼	蝼	蛄的蝼	
蝙	蝙	蝠的蝙	
蝥	斑蝥	的蝥	
螓	虫螓	的螓	
螯	虫螯	的螯	
螨	螨	虫的螨	
蟒	蟒	蛇的蟒	
蟆	蛤蟆	的蟆	
螈	蝾螈	的螈	
螅	水螅	的螅	
螭	螭	龙的螭	
螗	螗	蝉的螗	
螃	螃	蟹的螃	
螫	海蜇的螫	
蟥	蚂蟥	的蟥	
螬	蛴螬	的螬	
螵	螵	蛸的螵	
螳	螳	螂的螳	
蟋	蟋	蟀的蟋	
蟓	虫蟓	的蟓	
螽	螽	斯的螽	
蟑	蟑	螂的蟑	
蟀	蟋蟀	的蟀	
蟊	蟊	贼的蟊	
蟛	蟛	蜞的蟛	
蟪	蟪	蛄的蟪	
蟠	蟠	桃的蟠	
蟮	曲蟮	的蟮	
蠖	尺蠖	的蠖	
蠓	蠓	虫的蠓	
蟾	蟾	蜍的蟾	
蠊	虫蠊	的蠊	
蠛	蠛	蠓的蠛	
蠡	范蠡	的蠡	
蠹	蠹	虫的蠹	
蠼	蠼	螋的蠼	
缶	瓦缶	的缶	
罂	罂	粟的罂	
罄	告罄	的罄	
罅	罅	缝的罅	
舐	舐	犊的舐	
竺	天竺	的竺	
竽	烂竽	的竽	
笈	书箱的笈	
笃	笃	学的笃	
笄	簪子的笄	
笕	竹笕	的笕	
笊	笊	篱的笊	
笫	床笫	的笫	
笏	竹笏	的笏	
筇	筇	竹的筇	
笸	笸	箩的笸	
笪	姓笪	的笪	
笙	笙	歌的笙	
笱	竹笱	的笱	
笠	斗笠	的笠	
笥	竹笥	的笥	
笤	笤	帚的笤	
笳	胡笳	的笳	
笾	竹笾	的笾	
笞	鞭笞	的笞	
筘	竹筘	的筘	
筚	筚	户的筚	
筅	筅	帚的筅	
筵	筵	席的筵	
筌	渔筌	的筌	
筝	风筝	的筝	
筮	卜筮	的筮	
筻	筻	口的筻	
筢	竹筢	的筢	
筲	竹筲	的筲	
筱	竹筱	的筱	
箐	竹箐	的箐	
箦	竹箦	的箦	
箧	藤箧	的箧	
箸	筷箸	的箸	
箬	箬	竹的箬	
箝	箝	形的箝	
箨	竹箨	的箨	
箅	竹屉的箅	
箪	竹箪	的箪	
箜	箜	篌的箜	
箢	箢	箕的箢	
箫	洞箫	的箫	
箴	箴	言的箴	
篑	篑	筐的篑	
篁	竹篁	的篁	
篌	箜篌	的篌	
篝	篝	火的篝	
篚	竹筐的篚	
篥	竹栗的篥	
篦	篦	子的篦	
篪	篪	敌的篪	
簌	簌	簌	的簌	
篾	竹篾	的篾	
篼	篼	子的篼	
簏	书簏	的簏	
簖	鱼簖	的簖	
簋	竹簋	的簋	
簟	竹簟	的簟	
簪	簪	子的簪	
簦	竹簦	的簦	
簸	簸	箕的簸	
籁	万籁	的籁	
籀	籀	文的籀	
臾	须臾	的臾	
舁	舁	抬的舁	
舂	舂	米的舂	
舄	舄	斜的舄	
臬	臬	台的臬	
衄	鼻衄	的衄	
舡	周舡	的舡	
舢	舢	板的舢	
舣	舣	岸的舣	
舭	舭	船的舭	
舯	船舯	的舯	
舨	山舨	的舨	
舫	石舫	的舫	
舸	舸	船的舸	
舻	舳舻	的舻	
舳	舳	舻的舳	
舴	舴	艋的舴	
舾	舾	装的舾	
艄	船艄	的艄	
艉	周艉	的艉	
艋	舴艋	的艋	
艏	船艏	的艏	
艚	周艚	的艚	
艟	艨艟	的艟	
艨	艨	艟的艨	
衾	衾	枕的衾	
袅	袅	绕的袅	
袈	袈	裟的袈	
裘	裘	皮的裘	
裟	袈裟	的裟	
襞	皱襞	的襞	
羝	羊羝	的羝	
羟	羟	基的羟	
羧	羧	基的羧	
羯	羯	羊的羯	
羰	羰	基的羰	
羲	羲	之的羲	
籼	籼	米的籼	
敉	敉	平的敉	
粑	糍粑	的粑	
粝	糙粝	的粝	
粜	米粜	的粜	
粞	米粞	的粞	
粢	米粢	的粢	
粲	粲	然的粲	
粼	粼	粼	的粼	
粽	粽	子的粽	
糇	糇	粮的糇	
糌	糌	粑的糌	
糍	糍	粑的糍	
糈	米糈	的糈	
糅	米糅	的糅	
糗	米糗	的糗	
糨	糨	糊的糨	
艮	姓艮	的艮	
暨	暨	南的暨	
羿	羿	君的羿	
翎	花翎	的翎	
翕	翕	合的翕	
翥	翥	非的翥	
翡	翡	翠的翡	
翦	姓翦	的翦	
翩	翩	翩	的翩	
翮	雨翮	的翮	
翳	白翳	的翳	
糸	糸	部的糸	
絷	絷	缰的絷	
綦	綦	切的綦	
纛	纛	旗的纛	
麸	麦麸	的麸	
麴	姓麴	的麴	
赳	雄赳	的赳	
趔	趔	趄的趔	
趑	趑	居的趑	
趱	趱	赶的趱	
赧	赧	然的赧	
赭	赭	色的赭	
豇	豇	豆的豇	
豉	豆豉	的豉	
酊	酊	剂的酊	
酐	酸酐	的酐	
酎	酎	金的酎	
酏	药酏	的酏	
酤	酤	酒的酤	
酡	酡	然的酡	
酰	酰	基的酰	
酩	酩	酊的酩	
酯	酯	类的酯	
酽	酽	酒的酽	
酲	酒酲	的酲	
酴	酴	酒的酴	
酹	酹	酒的酹	
醌	苯醌	的醌	
醅	醅	酒的醅	
醐	提醐	的醐	
醍	醍	酪的醍	
醑	醑	剂的醑	
醢	酱醢	的醢	
醣	醣	房的醣	
醪	醪	糟的醪	
醭	醭	儿的醭	
醮	打醮	的醮	
醯	醋醯	的醯	
醵	醵	金的醵	
醴	酒醴	的醴	
醺	醉醺	的醺	
豕	豕	猪的豕	
鹾	鹾	盐的鹾	
趸	趸	批的趸	
跫	跫	然的跫	
踅	踅	摸的踅	
蹙	蹙	眉的蹙	
蹩	蹩	脚的蹩	
趵	趵	泉的趵	
趿	趿	拉的趿	
趼	老趼	的趼	
趺	趺	坐的趺	
跄	踉跄	的跄	
跖	跖	掌的跖	
跗	足跗	的跗	
跚	蹒跚	的跚	
跞	跞	走的跞	
跎	蹉跎	的跎	
跏	跏	趺的跏	
跛	跛	脚的跛	
跆	足台的跆	
跬	跬	步的跬	
跷	跷	脚的跷	
跸	跸	行的跸	
跣	跣	足的跣	
跹	翩跹	的跹	
跻	跻	登的跻	
跤	摔跤	的跤	
踉	踉	跄的踉	
跽	跽	跪的跽	
踔	踔	厉的踔	
踝	踝	骨的踝	
踟	踟	躇的踟	
踬	颠踬	的踬	
踣	踣	倒的踣	
踯	足踯	的踯	
踺	踺	子的踺	
蹀	蹀	躞的蹀	
踹	踹	门的踹	
踵	接踵	的踵	
踽	踽	踽	的踽	
踱	踱	步的踱	
蹉	蹉	跎的蹉	
蹁	蹁	跹的蹁	
蹂	蹂	躏的蹂	
蹑	足蹑	的蹑	
蹒	蹒	跚的蹒	
蹰	持蹰	的蹰	
蹶	蹶	子的蹶	
蹼	脚蹼	的蹼	
蹯	熊蹯	的蹯	
蹴	一蹴	的蹴	
躅	躅	竹的躅	
躏	蹂躏	的躏	
躔	躔	足的躔	
躐	族躐	的躐	
躜	躜	上的躜	
躞	躞	蹀的躞	
豸	虫豸	的豸	
貂	貂	皮的貂	
貊	貊	足的貊	
貅	貔貅	的貅	
貘	貘	科的貘	
貔	貔	虎的貔	
斛	斛	器的斛	
觖	觖	望的觖	
觞	酒觞	的觞	
觚	操觚	的觚	
觥	觥	绸的觥	
觫	觳觫	的觫	
觯	酒觯	的觯	
訾	訾	议的訾	
謦	謦	咳的謦	
雩	雩	祭的雩	
雳	霹雳	的雳	
雯	情雯	的雯	
霆	雷霆	的霆	
霁	霁	情的霁	
霈	雨霈	的霈	
霏	雨霏	的霏	
霎	霎	时的霎	
霪	霪	雨的霪	
霭	云霭	的霭	
霾	阴霾	的霾	
龀	龀	牙的龀	
龃	龃	龉的龃	
龅	龅	牙的龅	
龆	龆	年的龆	
龇	龇	牙的龇	
龉	龃龉	的龉	
龊	龌龊	的龊	
龌	龌	龊的龌	
鼋	鼋	鱼的鼋	
鼍	鼍	龙的鼍	
隼	隼	鸟的隼	
隽	隽	永的隽	
雎	雎	鸠的雎	
雒	姓雒	的雒	
雠	校雠	的雠	
銎	斧銎	的銎	
銮	金銮	的銮	
鋈	金鋈	的鋈	
錾	錾	刀的錾	
鍪	兜鍪	的鍪	
鏊	鏊	子的鏊	
鎏	纯鎏	的鎏	
鐾	鐾	刀的鐾	
鑫	金鑫	的鑫	
鱿	鱿	鱼的鱿	
鲂	鲂	鱼的鲂	
鲅	鲅	鱼的鲅	
鲆	鲆	鱼的鲆	
鲇	鲶鱼的鲇	
鲈	鲈	鱼的鲈	
稣	耶稣	的稣	
鲋	鲋	鲫的鲋	
鲎	鲎	虫的鲎	
鲐	鲐	鱼的鲐	
鲑	鲑	鱼的鲑	
鲒	鱼鲒	的鲒	
鲔	鲔	鱼的鲔	
鲕	鱼鲕	的鲕	
鲚	凤鲚	的鲚	
鲛	鲛	鲨的鲛	
鲞	鲞	鱼的鲞	
鲟	鱼鲟	的鲟	
鲠	骨鲠	的鲠	
鲡	鳗鲡	的鲡	
鲢	鲢	鱼的鲢	
鲣	鱼鲣	的鲣	
鲥	鲥	鱼的鲥	
鲦	鲦	鱼的鲦	
鲧	鱼鲧	的鲧	
鲨	鲨	鱼的鲨	
鲩	鲩	鱼的鲩	
鲫	鲫	鱼的鲫	
鲮	鱼鲮	的鲮	
鲰	鱼鲰	的鲰	
鲱	鲱	鱼的鲱	
鲲	鲲	鹏的鲲	
鲳	鲳	鱼的鲳	
鲴	鲴	鱼的鲴	
鲵	鱼鲵	的鲵	
鲶	鲶	鱼的鲶	
鲷	鱼鲷	的鲷	
鲺	动物的鲺	
鲻	鲻	鱼的鲻	
鲼	鲼	鱼的鲼	
鲽	鲽	鱼的鲽	
鳄	鳄	鱼的鳄	
鳅	泥鳅	的鳅	
鳆	鱼鳆	的鳆	
鳇	鳇	鱼的鳇	
鳊	鳊	鱼的鳊	
鳋	鳋	鱼的鳋	
鳌	鱼鳌	的鳌	
鳍	尾鳍	的鳍	
鳎	条鳎	的鳎	
鳏	鳏	夫的鳏	
鳐	鳐	鱼的鳐	
鳓	鳓	鱼的鳓	
鳔	鱼鳔	的鳔	
鳕	鳕	鱼的鳕	
鳗	鳗	鱼的鳗	
鳘	鳘	鱼的鳘	
鳙	鳙	鱼的鳙	
鳜	鳜	鱼的鳜	
鳝	鳝	鱼的鳝	
鳟	鳟	鱼的鳟	
鳢	乌鳢	的鳢	
靼	靼	子的靼	
鞅	商鞅	的鞅	
鞑	鞑	鞑	的鞑	
鞒	鞍鞒	的鞒	
鞔	皮鞔	的鞔	
鞯	鞍鞯	的鞯	
鞫	鞫	问的鞫	
鞣	鞣	割的鞣	
鞲	鞲	被的鞲	
鞴	鞴	马的鞴	
骱	脱骱	的骱	
骰	骰	子的骰	
骷	骷	髅的骷	
骶	骶	骨的骶	
骺	骨骺	的骺	
骼	骨骼	的骼	
髁	髁	骨的髁	
髀	髀	骨的髀	
髅	骷髅	的髅	
髂	髂	骨的髂	
髋	髋	骨的髋	
髌	髌	骨的髌	
髑	髑	髅的髑	
魅	魅	力的魅	
魃	旱魃	的魃	
魇	梦魇	的魇	
魉	魍魉	的魉	
魈	山魈	的魈	
魍	魍	魉的魍	
魑	魑	魅的魑	
飨	飨	客的飨	
餍	餍	足的餍	
餮	饕餮	的餮	
饕	饕	餮的饕	
饔	饔	飧的饔	
髡	髡	发的髡	
髦	时髦	的髦	
髯	髯	需的髯	
髫	髫	龄的髫	
髻	发髻	的髻	
髭	髭	发的髭	
髹	髹	漆的髹	
鬏	发鬏	的鬏	
鬓	鬓	发的鬓	
鬟	云鬟	的鬟	
鬣	鬣	狗的鬣	
麾	麾	下的麾	
縻	縻	绳的縻	
麂	麂	皮的麂	
麈	麈	尾的麈	
麋	麋	鹿的麋	
麒	麒	麟的麒	
鏖	鏖	战的鏖	
麝	麝	香的麝	
麟	骐麟	的麟	
黛	粉黛	的黛	
黜	黜	免的黜	
黝	黝	黑的黝	
黠	狡黠	的黠	
黟	黟	县的黟	
黢	黢	黑的黢	
黩	黩	武的黩	
黧	黧	黑的黧	
黥	黥	刑的黥	
黪	黪	黩的黪	
黯	黯	淡的黯	
鼢	鼢	鼠的鼢	
鼬	鼬	鼠的鼬	
鼯	鼯	鼠的鼯	
鼹	鼹	鼠的鼹	
鼷	鼷	鼠的鼷	
鼽	鼻鼽	的鼽	
鼾	打鼾	的鼾	
齄	鼻齄	的齄	
鸮	鸮	鸟的鸮	
琇	玉石的琇	
鲌	勃于的鲌	
僰	勃足的僰	
玥	神珠的玥	
髎	次疗的髎	
頔	美好的頔	
窅	深远的窅	
尪	尪	脆的尪	
瞭	料望的瞭	
蔊	喊菜的蔊	
薢	谢狗的薢	
芶	谢狗的芶	
祇	盛大的祇	
瓘	惯生的瓘	
巣	贼巢的巣	
犇	牛锛的犇	
槃	涅磐的槃	
俫	孩童的俫	
暍	椰困的暍	
萹	编竹的萹	
瞋	郴目的瞋	
珺	美育的珺	
吖	口丫的吖	
㐷	(㐷	責罵的罵的簡寫)的繁体
㐼	(㐼	同拯救的拯)的繁体
㑏	(㑏	同佇立的佇)的繁体
㑧	(㑧	同猶有餘悸的悸)的繁体
㑩	(㑩	侏儸紀的儸的簡寫)的繁体
㑴	(㑴	同侵掠的侵)的繁体
㒨	(㒨	同仙境的仙)的繁体
㒺	(㒺	同罔顧的罔)的繁体
㓂	(㓂	同賊寇的寇)的繁体
㓜	(㓜	同年幼的幼)的繁体
㓥	(㓥	劏豬的劏的簡寫)的繁体
㓨	(㓨	同刺激的刺)的繁体
㓶	(㓶	同鍥而不捨的鍥)的繁体
㕁	(㕁	同冷却器的却)的繁体
㕏	(㕏	同廚房的廚)的繁体
㕑	(㕑	同中央製作厨房的厨)的繁体
㕔	(㕔	同客廳的廳)的繁体
㕜	(㕜	同歷史的史)的繁体
㕠	(㕠	同雙方的雙)的繁体
㕥	(㕥	同以後的以)的繁体
㕶	(㕶	同嗯嗯的嗯)的繁体
㖁	(㖁	同吝嗇的吝)的繁体
㖊	(㖊	噚日的噚的簡寫)的繁体
㖞	(㖞	係喎的喎的簡寫)的繁体
㖧	(㖧	同接吻的吻)的繁体
㖽	(㖽	同嘖嘖稱奇的嘖)的繁体
㗃	(㗃	同接吻的吻)的繁体
㗉	(㗉	同戰略的略)的繁体
㗊	(㗊	同雷電的雷)的繁体
㗋	(㗋	同喉嚨的喉)的繁体
㗎	係㗎	的㗎	的繁体
㘉	(㘉	同唧筒的唧)的繁体
㘧	(㘧	同秩序的序)的繁体
㘪	(㘪	同消耗的耗)的繁体
㘭	(㘭	同坳背山的坳)的繁体
㘱	(㘱	同坍塌的坍)的繁体
㙬	(㙬	同無垠的垠)的繁体
㚁	(㚁	同銀翹的翹)的繁体
㚢	(㚢	同奴隸的奴)的繁体
㚩	(㚩	同姌嫋的姌)的繁体
㛮	(㛮	同大嫂的嫂)的繁体
㛰	(㛰	同婚姻的婚)的繁体
㜑	(㜑	同婆媳的婆)的繁体
㜸	(㜸	同孽債的孽)的繁体
㝛	(㝛	同宿舍的宿)的繁体
㝠	(㝠	同冥府的冥)的繁体
㝡	(㝡	同最好的最)的繁体
㝢	(㝢	同宇宙的宇)的繁体
㝱	(㝱	同夢想的夢)的繁体
㝿	(㝿	同跛足的跛)的繁体
㞐	(㞐	同居住的居)的繁体
㞢	(㞢	同之乎者也的之)的繁体
㞧	(㞧	同會議的會)的繁体
㟁	(㟁	同岸邊的岸)的繁体
㠀	(㠀	同島嶼的島)的繁体
㠄	(㠄	同嶍城的嶍)的繁体
㠷	(㠷	同帆船的帆)的繁体
㡌	(㡌	同帽子的帽)的繁体
㡠	(㡠	同一幀的幀)的繁体
㡧	(㡧	同一幀的幀)的繁体
㡭	(㡭	同繼續的繼)的繁体
㢓	(㢓	同障礙的障)的繁体
㢘	(㢘	同廉潔的廉)的繁体
㤂	(㤂	同緊急的急)的繁体
㤅	(㤅	同愛好的愛)的繁体
㤖	(㤖	懦弱的懦的簡寫)的繁体
㤙	(㤙	同恩怨的恩)的繁体
㤭	(㤭	驕傲的驕的簡寫)的繁体
㥦	(㥦	同愜意的愜)的繁体
㥫	(㥫	同惇誨的惇)的繁体
㦂	(㦂	同常識的常)的繁体
㦍	(㦍	同愕然的愕)的繁体
㦤	(㦤	同司馬懿的懿)的繁体
㦸	(㦸	同刀槍劍戟的戟)的繁体
㧑	(㧑	撝挹的撝的簡寫)的繁体
㧖	(㧖	同扼要的扼)的繁体
㧛	(㧛	招攬的攬的簡寫)的繁体
㧱	(㧱	同捉拿的拿)的繁体
㨗	(㨗	同捷運的捷)的繁体
㨘	(㨘	同擤鼻涕的擤)的繁体
㨪	(㨪	同搖晃的晃)的繁体
㨽	(㨽	同逼真的逼)的繁体
㨿	(㨿	同證據的據)的繁体
㩐	(㩐	同扽平的扽)的繁体
㩜	(㩜	同招攬的攬)的繁体
㩣	(㩣	同揮手的揮)的繁体
㩪	(㩪	同擷取的擷)的繁体
㪚	(㪚	同解散的散)的繁体
㪟	(㪟	同敦厚的敦)的繁体
㪫	(㪫	同叡山的叡)的繁体
㫴	(㫴	同咆哮的哮)的繁体
㬉	(㬉	同暖和的暖)的繁体
㬎	(㬎	同顯注的顯)的繁体
㬥	(㬥	同曝光的曝)的繁体
㬪	(㬪	同叠翠豪庭的叠)的繁体
㭊	(㭊	同分析的析)的繁体
㭒	(㭒	同耜脖的耜)的繁体
㭨	(㭨	同椰子的椰)的繁体
㮚	(㮚	同栗子的栗)的繁体
㮣	(㮣	同概況的概)的繁体
㮮	(㮮	同柑桔的桔)的繁体
㮵	(㮵	同栴朓的栴)的繁体
㯐	(㯐	同橢圓形的橢)的繁体
㯭	(㯭	同搖櫓的櫓)的繁体
㱃	(㱃	同飲食的飲)的繁体
㱕	(㱕	同歸還的歸)的繁体
㱨	(㱨	同殮房的殮)的繁体
㲊	(㲊	同叡山的叡)的繁体
㳂	(㳂	同沿海的沿)的繁体
㳄	(㳄	同垂涎的涎)的繁体
㳅	(㳅	同流動的流)的繁体
㳒	(㳒	同法律的法)的繁体
㳡	(㳡	漩渦的渦的簡寫)的繁体
㳿	(㳿	同渫雲的渫)的繁体
㴑	(㴑	同追本溯源的溯)的繁体
㴱	(㴱	同深淺的深)的繁体
㶳	(㶳	同灰燼的燼)的繁体
㸐	(㸐	同然後的然)的繁体
㸦	(㸦	同互相的互)的繁体
㹖	(㹖	同豢養的豢)的繁体
㹠	(㹠	同海豚的豚)的繁体
㼜	(㼜	同盎然的盎)的繁体
㼝	(㼝	同碗碟的碗)的繁体
㽞	(㽞	同停留的留)的繁体
㾌	(㾌	同癬疥的癬)的繁体
㾐	(㾐	同瘴癘的癘)的繁体
㾑	(㾑	同疙瘩的瘩)的繁体
㿅	(㿅	同癬疥的癬)的繁体
㿜	(㿜	同癟三的癟)(流氓)的繁体
㿡	(㿡	同兜圈的兜)的繁体
䀢	(䀢	同瞬間的瞬)的繁体
䂫	(䂫	同夯寶的夯)的繁体
䃺	(䃺	同磨擦的磨)的繁体
䅟	(䅟	穇子的穇的簡寫)(植物名)的繁体
䆒	(䆒	同研究的究)的繁体
䆻	(䆻	同竅門的竅)的繁体
䇇	(䇇	同流氓的氓)的繁体
䇲	(䇲	竹筴魚的筴的簡寫)的繁体
䇹	(䇹	同白箘湯的箘)的繁体
䈎	(䈎	同一頁書的頁)的繁体
䈰	(䈰	同筲箕的筲)的繁体
䉵	(䉵	同撰寫的撰)的繁体
䊀	(䊀	同糊塗的糊)的繁体
䊋	(䊋	同梳妝的妝)的繁体
䊪	(䊪	同糲飯的糲)的繁体
䊷	(䊷	同緇衣的緇)的繁体
䊸	(䊸	同紆子于歸的紆)的繁体
䋁	(䋁	同綆短汲深的綆)的繁体
䋎	(䋎	同破綻的綻)的繁体
䋒	(䋒	同紓尊降貴的紓)的繁体
䋣	(䋣	同繁榮的繁)的繁体
䌊	(䌊	同繇役繁興的繇)的繁体
䌓	(䌓	同繁榮的繁)的繁体
䌶	(䌶	緇衣的緇的簡寫)的繁体
䌽	(䌽	彩色的彩的簡寫)的繁体
䍁	(䍁	繸子的繸的簡寫)的繁体
䍐	(䍐	同罕有的罕)的繁体
䍑	(䍑	同罕有的罕)的繁体
䍩	(䍩	同養殖的養)的繁体
䎬	(䎬	泥耙的耙的簡寫)的繁体
䎱	(䎱	同泥耙的耙)的繁体
䒣	(䒣	同荏苒的苒)的繁体
䒷	(䒷	同檜樹的栝)的繁体
䓖	(䓖	芎藭的藭的簡寫)(川芎)的繁体
䓪	王䓪	鳴的䓪	的繁体
䔍	(䔍	同篤信的篤)的繁体
䕭	(䕭	同蕁麻的蕁)(植物)的繁体
䕸	(䕸	同秫秸的秸)的繁体
䖏	(䖏	同處境的處)的繁体
䖝	(䖝	同昆虫的虫)的繁体
䖟	(䖟	同虻僧的虻)的繁体
䖽	(䖽	同蛤蜊的蜊)(貝殼類動物)的繁体
䘏	(䘏	同撫恤的恤)的繁体
䘑	(䘑	同脉衝的脉)的繁体
䘚	(䘚	同兵卒的卒)的繁体
䘮	(䘮	同喪失的喪)的繁体
䘳	(䘳	同衿曲的衿)的繁体
䙓	(䙓	下襬的襬的簡寫)的繁体
䙷	(䙷	同得失的得)的繁体
䚻	(䚻	同謠言的謠)的繁体
䛐	(䛐	同詞語的詞)的繁体
䛒	(䛒	同辯論的辯)的繁体
䛡	(䛡	同說話的話)的繁体
䛧	(䛧	同謎語的謎)的繁体
䜩	(䜩	宴會的讌的簡寫)的繁体
䝔	(䝔	同鼬獾的獾)的繁体
䝟	(䝟	同猰瘉的猰)的繁体
䝯	(䝯	同流貤的貤)的繁体
䝿	(䝿	同貴重的貴)的繁体
䟖	(䟖	同一趟的趟)的繁体
䟡	(䟡	同胼手胝足的胝)的繁体
䟫	(䟫	同撐腰的撐)的繁体
䠀	(䠀	同一趟的趟)的繁体
䠥	(䠥	同蹩腳的蹩)的繁体
䠶	(䠶	同射擊的射)的繁体
䠷	高䠷	的䠷	的繁体
䡴	(䡴	同衝鋒的衝)的繁体
䡹	(䡹	同軒輊的輊)的繁体
䢜	(䢜	同歸還的歸)的繁体
䢩	(䢩	同御准的御)的繁体
䣃	(䣃	同起卸的卸)的繁体
䣛	(䣛	同膝蓋的膝)的繁体
䣱	(䣱	同酗酒的酗)的繁体
䦆	(䦆	钁頭的钁的簡寫)(挖土石和野草的農具)的繁体
䦨	(䦨	同闌珊的闌)的繁体
䧡	(䧡	同劉墉的墉)的繁体
䨦	(䨦	同滂沱大雨的滂)的繁体
䩄	(䩄	靦腆的靦的簡寫)的繁体
䩜	(䩜	同甲冑的冑)的繁体
䩭	(䩭	同羈留的羈)的繁体
䫇	(䫇	同虯髯的髯)的繁体
䫉	(䫉	同禮貌的貌)的繁体
䫍	(䫍	同趙孟頫的頫)的繁体
䬃	(䬃	同秋風颯颯的颯)的繁体
䬡	(䬡	同軒翥的翥)的繁体
䬪	(䬪	同餺飥的餺)(湯餅)的繁体
䬴	(䬴	同秣兵厲馬的秣)的繁体
䭅	(䭅	同糊塗的糊)的繁体
䭣	(䭣	同糯米糍的糍)的繁体
䭾	(䭾	同馱着的馱)的繁体
䰞	(䰞	同煮飯的煮)的繁体
䰟	(䰟	同靈魂的魂)的繁体
䰻	(䰻	同漁翁的漁)的繁体
䱇	(䱇	同鱔魚的鱔)的繁体
䱉	(䱉	同鱔魚的鱔)的繁体
䱔	(䱔	同鰷魚的鰷)的繁体
䲔	(䲔	同鯨魚的鯨)的繁体
䲠	(䲠	鰆魚的鰆的簡寫)(又名馬駮魚)的繁体
䲨	(䲨	同鴻圖的鴻)的繁体
䲫	(䲫	同斑鳩的鳩)的繁体
䳒	(䳒	同鳶山的鳶)的繁体
䳘	(䳘	同天鵝的鵝)的繁体
䳭	城中煙氣䳭	天的䳭	的繁体
䳺	(䳺	同鵪鶉的鵪)的繁体
䴸	(䴸	同麥麩的麩)的繁体
䵷	(䵷	同哇哇墮地的哇)的繁体
䶌	(䶌	同疱疹的疱)的繁体
䶥	(䶥	同齟齬的齟)的繁体
䶧	(䶧	同咬人的咬)的繁体
丄	(丄	同上下的上)的繁体
丟	丟	棄的丟	的繁体
並	並	且的並	的繁体
丳	(丳	把肉串起來燒的籤子)的繁体
乆	(乆	同永久的久)的繁体
乗	(乗	同乘坐的乘)的繁体
乚	(乚	同甲乙的乙)的繁体
乣	(乣	同糾紛的糾)的繁体
乪	圍乪	街的乪	的繁体
乸	豬乸	的乸	的繁体
乹	(乹	同乾淨的乾)的繁体
亁	(亁	同乾淨的乾)的繁体
亂	混亂	的亂	的繁体
亙	橫亙	的亙	的繁体
亝	(亝	同齊全的齊)的繁体
亞	亞	洲的亞	的繁体
亯	(亯	同亨通的亨)的繁体
亱	(亱	同夜晚的夜)的繁体
亷	(亷	同廉潔的廉)的繁体
亼	(亼	同集中的集)的繁体
亾	(亾	同死亡的亡)的繁体
仌	(仌	同冰冷的冰)的繁体
仭	(仭	同千仞的仞)的繁体
伀	(伀	稱丈夫的父親)的繁体
伋	伋	伋	的伋	的繁体
伕	馬伕	的伕	的繁体
伷	(伷	同甲冑的冑)的繁体
伻	伻	伻	的伻	的繁体
伾	伾	伾	(眾多)的伾	的繁体
佀	(佀	同似乎的似)的繁体
佇	佇	立的佇	的繁体
佈	佈	置的佈	的繁体
佉	(佉	神的名)的繁体
佒	(佒	同仰慕的仰)的繁体
佔	佔	領的佔	的繁体
佢	(佢	他的意思)的繁体
佪	俳佪	(同徘徊)的佪	的繁体
併	併	發的併	的繁体
佺	偓佺	(仙人名)的佺	的繁体
佽	佽	助的佽	的繁体
侁	侁	眷的侁	的繁体
侂	(侂	寄托)的繁体
來	來	往的來	的繁体
侌	(侌	同陰暗的陰)的繁体
侖	美侖	美奐的侖	的繁体
侘	侘	傺的侘	的繁体
侶	伴侶	的侶	的繁体
侷	侷	促的侷	的繁体
侹	(侹	平直)的繁体
侻	(侻	同脫離的脫)的繁体
係	關係	的係	的繁体
俉	(俉	同違迕的迕)的繁体
俛	(俛	同俯首稱臣之俯)的繁体
俠	俠	義的俠	的繁体
俬	傢俬	的俬	的繁体
俵	(俵	把東西分給別人)的繁体
俻	(俻	同預備的備)的繁体
倀	為虎作倀	的倀	的繁体
倂	(倂	同兼并的并)的繁体
倃	(倃	同咱們的咱)的繁体
倆	我倆	的倆	的繁体
倉	倉	庫的倉	的繁体
個	個	人的個	的繁体
倐	(倐	同倏忽的倏)的繁体
們	人們	的們	的繁体
倕	(倕	古代相傳的巧匠名)的繁体
倖	倖	免的倖	的繁体
倣	模倣	的倣	的繁体
値	(値	同價值的值)的繁体
倫	倫	理的倫	的繁体
倸	(倸	同理睬的睬)的繁体
倽	(倽	同是啥的啥)的繁体
偁	(偁	名稱之稱的本體字)的繁体
偉	偉	大的偉	的繁体
偍	(偍	同媞媞的媞)的繁体
偓	偓	促的偓	的繁体
偝	(偝	背棄或背向著)的繁体
偟	仿偟	的偟	的繁体
偠	偠	紹的偠	的繁体
偢	偢	睬的偢	的繁体
偩	(偩	同負責的負)的繁体
偪	(偪	同逼真的逼)的繁体
偭	偭	規愈矩的偭	的繁体
偯	(偯	哭的餘聲)的繁体
偰	(偰	傳說中商族的始祖)的繁体
偲	切切偲	偲	的偲	的繁体
側	側	面的側	的繁体
偵	偵	察的偵	的繁体
偸	(偸	同偷竊的偷)的繁体
偺	偺	們的偺	的繁体
偽	偽	裝的偽	的繁体
傑	傑	出的傑	的繁体
傔	(傔	侍從)的繁体
傕	李傕	的傕	的繁体
傖	傖	又的傖	的繁体
傘	雨傘	的傘	的繁体
備	預備	的備	的繁体
傚	仿傚	的傚	的繁体
傞	傞	傞	(醉酒跳舞)的傞	的繁体
傢	傢	俬的傢	的繁体
傭	傭	工的傭	的繁体
傯	倥傯	的傯	的繁体
傳	傳	統的傳	的繁体
傴	傴	僂的傴	的繁体
債	債	務的債	的繁体
傷	傷	害的傷	的繁体
傹	(傹	同僵直的僵)的繁体
傾	傾	斜的傾	的繁体
僂	痀僂	的僂	的繁体
僃	(僃	同預備的備)的繁体
僅	僅	有的僅	的繁体
僇	(僇	同殺戮之戮)的繁体
僉	僉	同的僉	的繁体
僊	(僊	跳舞時舞姿輕快)的繁体
僎	僎	謙的僎	的繁体
僑	華僑	的僑	的繁体
僒	(僒	同窘迫的窘)的繁体
僓	(僓	嫺雅)的繁体
僕	僕	人的僕	的繁体
僗	(僗	做工)的繁体
僝	僝	僽的僝	的繁体
僢	(僢	同舛誤的舛)的繁体
僥	僥	幸的僥	的繁体
僨	僨	事的僨	的繁体
僩	僩	然的僩	的繁体
僱	僱	傭的僱	的繁体
僴	(僴	同僩然的僩)的繁体
僶	(僶	努力做事)的繁体
僸	(僸	仰視)的繁体
價	價	格的價	的繁体
僽	僝僽	的僽	的繁体
僾	(僾	彷佛)的繁体
僿	(僿	塞住或節約)的繁体
儀	儀	式的儀	的繁体
儂	(儂	蘇州話我或他)的繁体
儃	(儃	不前進的樣子)的繁体
億	億	萬富翁的億	的繁体
儈	市儈	的儈	的繁体
儉	勤儉	的儉	的繁体
儐	儐	相的儐	的繁体
儔	(儔	同類的人或伴侶)的繁体
儕	同儕	的儕	的繁体
儘	儘	管的儘	的繁体
儛	(儛	同舞蹈的舞)的繁体
償	償	還的償	的繁体
優	優	美的優	的繁体
儲	儲	備的儲	的繁体
儳	儳	言(打斷說話)的儳	的繁体
儷	伉儷	的儷	的繁体
儸	侏儸	紀的儸	的繁体
儻	倜儻	的儻	的繁体
儼	儼	如的儼	的繁体
兇	兇	惡的兇	的繁体
兌	兌	現的兌	的繁体
兎	(兎	同白兔的兔)的繁体
兒	兒	子的兒	的繁体
兗	兗	州的兗	的繁体
兠	(兠	同兜圈的兜)的繁体
兦	(兦	同死亡的亡)的繁体
內	內	外的內	的繁体
兩	兩	個的兩	的繁体
兾	(兾	同希冀的冀)的繁体
冄	(冄	同冉冉上昇的冉)的繁体
冇	有冇	的冇	的繁体
冊	註冊	的冊	的繁体
冐	(冐	同冒險的冒)的繁体
冑	甲冑	的冑	的繁体
冚	冚	被的冚	的繁体
冞	(冞	深入的意思)的繁体
冣	(冣	同最好的最)的繁体
冪	(冪	蓋食物的巾)的繁体
冺	(冺	同未泯的泯)的繁体
凃	(凃	同涂謹申的涂)的繁体
凈	(乾凈	的淨俗體字)的繁体
凍	凍	結的凍	的繁体
凓	溧陽縣的凓	的繁体
凘	(凘	冰的消融)的繁体
凜	凜	冽的凜	的繁体
凣	(凣	同平凡的凡)的繁体
処	(処	同處境的處)的繁体
凱	凱	旋的凱	的繁体
凴	(凴	同文憑的憑)的繁体
凷	(凷	同石塊的塊)的繁体
刄	(刄	同刀刃的刃)的繁体
刉	(刉	劃破之意思)的繁体
刓	(刓	削宛刻)的繁体
別	分別	的別	的繁体
刧	(刧	同劫匪的劫)的繁体
刪	刪	除的刪	的繁体
刱	(刱	同創作的創)的繁体
刲	(刲	割出之意思)的繁体
刴	(刴	同剁碎的剁)的繁体
刵	(刵	古代割耳的刑罰)的繁体
刾	(刾	刺激的刺的簡寫)的繁体
剄	(剄	用刀割頸)的繁体
則	則	例的則	的繁体
剉	(剉	折傷)的繁体
剋	剋	星的剋	的繁体
剎	剎	那的剎	的繁体
剏	(剏	同創作的創)的繁体
剙	(剙	同創作的創)的繁体
剛	剛	強的剛	的繁体
剝	剝	削的剝	的繁体
剠	(剠	同侵掠的掠)的繁体
剭	(剭	殺戮)的繁体
剮	(剮	割肉離骨)的繁体
剳	(剳	同札記的札)的繁体
剴	剴	切(符合事理)的剴	的繁体
創	創	作的創	的繁体
剷	剷	除的剷	的繁体
剹	(剹	同殺戮的戮)的繁体
劃	計劃	的劃	的繁体
劄	劄	記的劄	的繁体
劇	劇	烈的劇	的繁体
劉	(姓氏劉	)的繁体
劊	劊	子手的劊	的繁体
劌	曹劌	論戰的劌	的繁体
劍	刀劍	的劍	的繁体
劏	劏	豬的劏	的繁体
劑	調劑	的劑	的繁体
劒	(劒	同刀劍的劍)的繁体
劖	(劖	鑿或斷)的繁体
劤	(劤	同勁力的勁)的繁体
劦	(劦	力不斷續)的繁体
劵	(劵	同証券的券)的繁体
劻	劻	勷的劻	的繁体
劼	(劼	小心謹慎)的繁体
勁	勁	力的勁	的繁体
勌	(勌	同疲倦的倦)的繁体
勑	(勑	同敕令的敕)的繁体
動	動	作的動	的繁体
勗	勗	勉(勉勵)的勗	的繁体
務	任務	的務	的繁体
勛	(勛	同勳章的勳)的繁体
勝	勝	負的勝	的繁体
勞	勞	動的勞	的繁体
勠	(勠	同殺戮的戮)的繁体
勢	形勢	的勢	的繁体
勣	(勣	功業之意)的繁体
勩	(勩	勞苦)的繁体
勱	(勱	通豪邁的邁)的繁体
勲	(勲	同勛章的勛)的繁体
勳	勳	章的勳	的繁体
勵	鼓勵	的勵	的繁体
勸	勸	告的勸	的繁体
勻	均勻	的勻	的繁体
匃	(匃	同乞丐的丐)的繁体
匄	(匄	同乞丐的丐)的繁体
匉	匉	訇的匉	的繁体
匊	匊	取的匊	的繁体
匋	(匋	陶瓷的陶古字)的繁体
匜	(匜	古代的盥器)的繁体
匭	(匭	匣子或小箱子)的繁体
匯	匯	款的匯	的繁体
匱	民窮財匱	的匱	的繁体
匲	(匲	同陪奩的奩)的繁体
匵	(匵	同劍則啟櫝的櫝)的繁体
匼	(匼	地名)的繁体
匽	(匽	停息)的繁体
區	區	分的區	的繁体
卋	(卋	同世界的世)的繁体
卌	(卌	四十)的繁体
協	協	助的協	的繁体
卝	(卝	同礦產的礦)的繁体
卲	(姓氏卲	)的繁体
卹	(卹	同撫恤的恤)的繁体
卻	冷卻	的卻	的繁体
卽	(卽	同即時的即)的繁体
厀	(厀	同膝蓋的膝)的繁体
厐	(厐	龐大的龐的簡寫)的繁体
厔	盩厔	的厔	的繁体
厙	(厙	村莊)的繁体
厪	(厪	同僅有的僅)的繁体
厭	厭	惡的厭	的繁体
厰	(厰	同廠商的廠)的繁体
厲	厲	害的厲	的繁体
厴	(厴	蟹腹或螺殼)的繁体
厷	(厷	同肱骨的肱)的繁体
厺	(厺	同來去的去)的繁体
參	參	與的參	的繁体
叆	(叆	靉靉的靉的簡寫)(雲濃厚的樣子)的繁体
叇	(叇	靉靆的靆的簡寫)(雲盛的樣子)的繁体
収	(収	同收入的收)的繁体
叚	(叚	同真假的假)的繁体
叜	(叜	同老叟的叟)的繁体
叡	叡	山的叡	的繁体
叢	叢	林的叢	的繁体
吋	英吋	的吋	的繁体
吚	(吚	同咿啞的咿)的繁体
吰	噌吰	的吰	的繁体
吳	(姓氏吳	)的繁体
吶	吶	喊的吶	的繁体
吽	吽	聲的吽	的繁体
吿	(吿	同告訴的告)的繁体
呂	(姓氏呂	)的繁体
呌	(呌	同叫喊的叫)的繁体
呎	英呎	的呎	的繁体
呝	(呝	同打呃的呃)的繁体
呣	(呣	嘆詞表示疑問)的繁体
呪	(呪	同咒罵的咒)的繁体
呫	呫	呫	(喋喋不休)的呫	的繁体
呴	(呴	張口吹氣)的繁体
咁	咁	多的咁	的繁体
咈	(咈	不以為言的聲音)的繁体
咊	(咊	同和平的和)的繁体
咍	(咍	嘲笑)的繁体
咑	(咑	吆喝牲口前進的聲音)的繁体
咗	食咗	的咗	的繁体
咡	(咡	嘴巴旁邊)的繁体
咥	(咥	大笑的樣子)的繁体
咵	(咵	同侉大個兒的侉)的繁体
咷	嚎咷	的咷	的繁体
咺	(咺	有威儀的樣)的繁体
哋	我哋	的哋	的繁体
員	職員	的員	的繁体
哶	(哶	同咩咩的咩)的繁体
唗	(唗	斥責人的語詞)的繁体
唘	(唘	同開啟的啟)的繁体
唙	(唙	同嘀咕的嘀)的繁体
唲	嚅唲	的唲	的繁体
唵	(唵	佛教咒語的發聲字)的繁体
唸	唸	經的唸	的繁体
啋	(啋	助語詞)的繁体
啍	啍	啍	的啍	的繁体
啎	(啎	同忤逆的忤)的繁体
問	問	答的問	的繁体
啑	(啑	水鳥吃東西的聲音)的繁体
啔	(啔	同開啟的啟)的繁体
啗	啗	之以利的啗	的繁体
啙	(啙	同訾厲的訾)(疾病名)的繁体
啚	(啚	同圖話的圖)的繁体
啞	啞	巴的啞	的繁体
啟	開啟	的啟	的繁体
啣	口啣	着的啣	的繁体
啫	啫	喱的啫	的繁体
啰	(啰	囉嗦的囉的簡寫)的繁体
啱	啱	晒的啱	的繁体
啲	(啲	助語詞)的繁体
喆	陶喆	的喆	的繁体
喎	係喎	的喎	的繁体
喓	(喓	放聲鳴叫)的繁体
喚	叫喚	的喚	的繁体
喞	(喞	同唧筒的唧)的繁体
喦	(喦	多言)的繁体
喨	(喨	聲音清而亮)的繁体
喪	喪	失的喪	的繁体
喫	(喫	同吃飯的吃)的繁体
喬	喬	木的喬	的繁体
喭	(喭	粗俗)的繁体
單	單	一的單	的繁体
喲	(喲	用於句尾的助詞)的繁体
喺	喺	度的喺	的繁体
嗁	(嗁	同啼哭的啼)的繁体
嗆	喝水嗆	着了的嗆	的繁体
嗇	吝嗇	的嗇	的繁体
嗎	嗎	啡的嗎	的繁体
嗐	(嗐	嘆詞)的繁体
嗙	瞎嗙	的嗙	的繁体
嗚	嗚	呼的嗚	的繁体
嗛	頰嗛	的嗛	的繁体
嗩	嗩	吶的嗩	的繁体
嗰	嗰	章的嗰	的繁体
嗶	嗶	嗶	聲的嗶	的繁体
嗸	(嗸	同嗷嗷的嗷)的繁体
嗻	(嗻	同啫喱的啫)的繁体
嘅	我嘅	的嘅	的繁体
嘆	嘆	氣的嘆	的繁体
嘍	嘍	囉的嘍	的繁体
嘐	(嘐	言語浮誇)的繁体
嘑	(嘑	同呼吸的呼)的繁体
嘒	(嘒	微小的樣子)的繁体
嘓	(嘓	蛙的叫聲)的繁体
嘔	嘔	吐的嘔	的繁体
嘕	(嘕	笑的樣子)的繁体
嘖	嘖	嘖	稱奇的嘖	的繁体
嘗	嘗	試的嘗	的繁体
嘜	嘜	頭的嘜	的繁体
嘠	(嘠	同嘎嘎的嘎)的繁体
嘢	乜嘢	的嘢	的繁体
嘥	嘥	氣的嘥	的繁体
嘩	喧嘩	的嘩	的繁体
嘮	嘮	叨的嘮	的繁体
嘯	海嘯	的嘯	的繁体
嘰	(嘰	象聲詞)的繁体
嘵	嘵	咋的嘵	的繁体
嘸	(嘸	不精明)的繁体
嘽	(嘽	緩慢)的繁体
噀	(噀	含在咀裡再噴出去)的繁体
噁	噁	心的噁	的繁体
噂	(噂	聚在一塊兒談論)的繁体
噆	(噆	用齒咬唇)的繁体
噉	(噉	吃)的繁体
噊	(噊	鳥鳴聲)的繁体
噏	照噏	的噏	的繁体
噐	(噐	同器材的器)的繁体
噑	(噑	同嗥叫的嗥)的繁体
噓	吹噓	的噓	的繁体
噚	噚	日的噚	的繁体
噟	(噟	同應該的應)的繁体
噠	噠	噠	聲的噠	的繁体
噡	(噡	同譫言的譫)的繁体
噥	噥	噥	的噥	的繁体
噯	(噯	嘆詞)的繁体
噴	噴	出的噴	的繁体
噸	一噸	的噸	的繁体
噹	叮噹	的噹	的繁体
嚀	叮嚀	的嚀	的繁体
嚇	恐嚇	的嚇	的繁体
嚐	品嚐	的嚐	的繁体
嚕	咕嚕	的嚕	的繁体
嚙	嚙	合的嚙	的繁体
嚟	走嚟	的嚟	的繁体
嚥	吞嚥	的嚥	的繁体
嚦	嚦	嚦	鶯聲的嚦	的繁体
嚨	喉嚨	的嚨	的繁体
嚫	嚫	錢(把錢給和尚)的嚫	的繁体
嚬	嚬	呻(呼痛聲)的嚬	的繁体
嚭	伯嚭	(人名)的嚭	的繁体
嚮	嚮	導的嚮	的繁体
嚴	嚴	肅的嚴	的繁体
嚶	嚶	嚶	的嚶	的繁体
嚻	(嚻	同囂張的囂)的繁体
嚽	(嚽	同吸啜的啜)的繁体
囀	鶯啼燕囀	的囀	的繁体
囁	囁	嚅的囁	的繁体
囂	囂	張的囂	的繁体
囈	夢囈	的囈	的繁体
囉	囉	嗦的囉	的繁体
囋	藥囋	的囋	的繁体
囌	嚕囌	的囌	的繁体
囍	雙囍	臨門的囍	的繁体
囏	(囏	同艱難的艱)的繁体
囑	囑	咐的囑	的繁体
囓	囓	齒類的囓	的繁体
囘	(囘	同回答的回)的繁体
囙	(囙	同因為的因)的繁体
囦	(囦	同深淵的淵)的繁体
囪	(囪	同煙囱的囱)的繁体
囬	(囬	同回答的回)的繁体
囮	(囮	鳥名)的繁体
囷	(囷	古代圓形的穀倉)的繁体
圂	(圂	同溷穢的溷)的繁体
圅	(圅	同函件的函)的繁体
圇	囫圇	吞棗的圇	的繁体
國	國	家的國	的繁体
圍	周圍	的圍	的繁体
園	花園	的園	的繁体
圓	圓	形的圓	的繁体
圖	圖	話的圖	的繁体
圗	(圗	同圖話的圖)的繁体
團	團	結的團	的繁体
坉	田坉	的坉	的繁体
坋	坋	飾的坋	的繁体
坣	(坣	同天堂的堂)的繁体
坰	(坰	郊外)的繁体
坵	烏坵	的坵	的繁体
垕	神垕	的垕	的繁体
垚	(垚	同堯舜之堯字)的繁体
垜	(垜	同草垛的垛)的繁体
垝	(垝	毀壞或倒塌)的繁体
垞	(垞	小丘)的繁体
垟	翁垟	的垟	的繁体
垵	(垵	同掩)的繁体
埊	(埊	同天地的地)的繁体
埓	(埓	壝埒的埒的簡寫)(有矮牆圍繞的壇)的繁体
埗	深水埗	的埗	的繁体
埜	(埜	同野獸的野)的繁体
埰	葬地稱埰	的埰	的繁体
埳	(埳	同坎坷的坎)的繁体
埵	埵	防的埵	的繁体
埶	(埶	同勢力的勢)的繁体
執	執	行的執	的繁体
埼	(埼	彎曲的岸)的繁体
堁	埵堁	的堁	的繁体
堃	葉澍堃	(人名)的堃	的繁体
堄	埤堄	的堄	的繁体
堅	堅	強的堅	的繁体
堈	(堈	甕)的繁体
堉	(堉	肥沃的土地)的繁体
堊	白堊	紀的堊	的繁体
堌	黃堌	的堌	的繁体
堖	(堖	同腦袋的腦)的繁体
堗	(堗	同突然的突)的繁体
堝	坩堝	的堝	的繁体
堧	(堧	城下田)的繁体
堨	揚塵起堨	的堨	的繁体
堯	堯	舜的堯	的繁体
報	報	告的報	的繁体
堲	堲	保祿修院的堲	的繁体
場	場	所的場	的繁体
堺	(堺	同世界的界)的繁体
塈	(塈	休)的繁体
塊	石塊	的塊	的繁体
塋	塋	田的塋	的繁体
塗	塗	改的塗	的繁体
塙	(塙	同確實的確)的繁体
塚	衣棺塚	的塚	的繁体
塟	(塟	同葬禮的葬)的繁体
塡	(塡	同填充的填)的繁体
塢	船塢	的塢	的繁体
塭	塭	仔的塭	的繁体
塱	衙前塱	道的塱	的繁体
塲	(塲	同場所的場)的繁体
塴	(塴	棺木入土)的繁体
塵	塵	土的塵	的繁体
塹	天塹	的塹	的繁体
塼	(塼	車瓦)的繁体
塿	(塿	小土丘)的繁体
墈	(墈	險陡的堤岸)的繁体
墊	墊	支的墊	的繁体
墋	(墋	沙土)的繁体
墐	(墐	塗塞)的繁体
墖	(墖	同燈塔的塔)的繁体
墘	港墘	的墘	的繁体
墜	墜	落的墜	的繁体
墝	(墝	貧瘠的土地)的繁体
墠	(墠	清除場地以行祭禮)的繁体
墡	(墡	白色的填土)的繁体
墣	(墣	土塊)的繁体
墫	(墫	酒器)的繁体
墬	(墬	地方的地的古體字)的繁体
墮	墮	落的墮	的繁体
墯	(墯	同墮落的墮)的繁体
墱	(墱	級次)的繁体
墳	墳	墓的墳	的繁体
墾	開墾	的墾	的繁体
壄	(壄	同野獸的野)的繁体
壆	堤壆	的壆	的繁体
壇	天壇	的壇	的繁体
壍	(壍	同天塹的塹)的繁体
壎	壎	悍的壎	的繁体
壐	(壐	同玉璽的璽)的繁体
壓	壓	迫的壓	的繁体
壘	堡壘	的壘	的繁体
壙	壙	野的壙	的繁体
壚	(壚	黑色的土壞)的繁体
壛	(壛	同房檐的檐)的繁体
壝	壝	埒(有矮牆圍繞的壇)的壝	的繁体
壞	好壞	的壞	的繁体
壟	壟	斷的壟	的繁体
壢	中壢	的壢	的繁体
壩	堤壩	的壩	的繁体
壯	壯	大的壯	的繁体
壸	(壸	酒壼的壼的簡寫)的繁体
壺	茶壺	的壺	的繁体
壼	酒壼	的壼	的繁体
壽	壽	命的壽	的繁体
夀	(夀	同壽命的壽)的繁体
夆	夆	典的夆	的繁体
夊	(夊	同綏遠的綏)的繁体
夒	(夒	動物名)的繁体
夘	(夘	同卯時的卯)的繁体
夝	(夝	同晴朗的晴)的繁体
夠	足夠	的夠	的繁体
夢	夢	想的夢	的繁体
夬	(夬	六十四卦之一)的繁体
夾	夾	縫的夾	的繁体
奅	(奅	同槍炮的炮)的繁体
奐	美侖美奐	的奐	的繁体
奓	頭髮奓	著的奓	的繁体
奧	奧	妙的奧	的繁体
奩	陪奩	的奩	的繁体
奪	爭奪	的奪	的繁体
奮	奮	鬥的奮	的繁体
奼	(奼	誇耀)的繁体
妎	妎	忌的妎	的繁体
妘	(姓氏妘	)的繁体
妝	梳妝	的妝	的繁体
妳	(妳	女的你)的繁体
妷	(妷	同世侄的侄)的繁体
妺	(妺	古人名用字)的繁体
姁	姁	姁	(快樂的樣子)的姁	的繁体
姌	姌	嫋的姌	的繁体
姍	姍	姍	來遲的姍	的繁体
姤	(姤	六十四卦之一)的繁体
姦	強姦	的姦	的繁体
姧	(姧	同奸詐的奸)的繁体
姪	姪	女的姪	的繁体
姮	姮	娥的姮	的繁体
姸	(姸	同爭妍鬥麗的妍)的繁体
姺	(姺	古國名)的繁体
姽	(姽	嫿)的繁体
娀	(娀	古國名)的繁体
娒	(娒	同侮辱的侮)的繁体
娛	娛	樂的娛	的繁体
娭	(娭	古代婦女的賤稱)的繁体
娿	(娿	同婀娜的婀)的繁体
婁	蒙特婁	的婁	的繁体
婐	(婐	侍女)的繁体
婑	婑	媠(美好的樣子)的婑	的繁体
婓	(婓	女神名)的繁体
婞	婞	直的婞	的繁体
婠	婠	妠的婠	的繁体
婥	婥	約的婥	的繁体
婦	婦	女的婦	的繁体
婬	(婬	同淫慾的淫)的繁体
婭	婭	婿的婭	的繁体
媍	(媍	同婦女的婦)的繁体
媕	(媕	不安的樣子)的繁体
媞	(媞	一種果實)的繁体
媟	狎媟	的媟	的繁体
媠	(媠	同懶惰的惰)的繁体
媢	媢	婦的媢	的繁体
媦	媦	婿的媦	的繁体
媧	女媧	的媧	的繁体
媮	媮	合取容的媮	的繁体
媯	媯	覽的媯	的繁体
媼	媼	嫗的媼	的繁体
媽	媽	媽	的媽	的繁体
嫋	姌嫋	的嫋	的繁体
嫗	(嫗	老的女人)的繁体
嫥	(嫥	專一)的繁体
嫮	(嫮	華美)的繁体
嫰	(嫰	同嫩綠的嫩)的繁体
嫲	嫲	嫲	的嫲	的繁体
嫵	嫵	媚(姿態美麗)的嫵	的繁体
嫻	嫻	熟的嫻	的繁体
嫽	(嫽	北方語外祖母)的繁体
嫿	(嫿	文靜美好的樣子)的繁体
嬃	(楚國人稱姊姊為嬃	)的繁体
嬅	楊千嬅	的嬅	的繁体
嬈	嬌嬈	的嬈	的繁体
嬋	嬋	娟的嬋	的繁体
嬌	嬌	娃的嬌	的繁体
嬝	嬝	娜的嬝	的繁体
嬡	令嬡	的嬡	的繁体
嬤	(嬤	北方稱老婦或母親)的繁体
嬪	妃嬪	的嬪	的繁体
嬰	嬰	兒的嬰	的繁体
嬸	嬸	母的嬸	的繁体
嬾	嬌嬾	(怠惰)的嬾	的繁体
嬿	嬿	婉的嬿	的繁体
孃	舞孃	的孃	的繁体
孌	孌	童的孌	的繁体
孏	(孏	同懶惰的懶)的繁体
孖	孖	寶的孖	的繁体
孫	子孫	的孫	的繁体
學	學	習的學	的繁体
孼	(孼	同孽債的孽)的繁体
孿	孿	生的孿	的繁体
宔	(宔	同主要的主)的繁体
宧	(姓氏宧	)的繁体
宮	宮	殿的宮	的繁体
宼	(宼	同賊寇的寇)的繁体
寀	(寀	同神采的采)的繁体
寃	(寃	同冤枉的冤)的繁体
寍	(寍	同寧靜的寧)的繁体
寔	寔	于叢棘的寔	的繁体
寕	(寕	同寧靜的寧)的繁体
寖	(寖	浸淫)的繁体
寗	(寗	同寧靜的寧)的繁体
寜	(寜	同寧靜的寧)的繁体
寢	寢	室的寢	的繁体
實	現實	的實	的繁体
寧	寧	靜的寧	的繁体
審	審	查的審	的繁体
寪	(姓氏寪	)的繁体
寫	寫	字的寫	的繁体
寬	寬	大的寬	的繁体
寱	(寱	同夢囈的囈)的繁体
寵	寵	物的寵	的繁体
寶	寶	貴的寶	的繁体
尀	(尀	同居心叵測的叵)的繁体
將	將	來的將	的繁体
專	專	業的專	的繁体
尋	尋	找的尋	的繁体
尌	(姓氏尌	)的繁体
對	對	錯的對	的繁体
導	導	師的導	的繁体
尙	(尙	同高尚的尚)的繁体
尞	(尞	同燎原的燎)的繁体
尠	(尠	同新鮮的鮮)的繁体
尨	(尨	同龐大的龐)的繁体
尩	(尩	同尪仔的尪)的繁体
尲	(尲	同尷尬的尷)的繁体
尷	尷	尬的尷	的繁体
屄	(屄	女生殖器)的繁体
屆	屆	滿的屆	的繁体
屌	(屌	男生殖器)的繁体
屍	屍	體的屍	的繁体
屛	(屛	同屏障的屏)的繁体
屜	抽屜	的屜	的繁体
屝	(屝	柴門)的繁体
屢	屢	次的屢	的繁体
層	層	次的層	的繁体
屧	(屧	木屐)的繁体
屨	屨	賤踊貴的屨	的繁体
屬	屬	於的屬	的繁体
屼	(屼	光禿的山)的繁体
岏	巑岏	的岏	的繁体
岝	岝	山的岝	的繁体
岡	岡	巒的岡	的繁体
岧	岧	嵽的岧	的繁体
岨	岨	山的岨	的繁体
岴	(岴	同崎嶇的嶇)的繁体
岹	(岹	同岧嵽的岧)的繁体
峇	峇	里島的峇	的繁体
峊	(峊	同阜陵的阜)的繁体
峕	(峕	同時間的時)的繁体
峛	(峛	同迤邐的邐)的繁体
峝	(峝	同崆峒派的峒)的繁体
峞	(峞	同馬嵬坡下泥土中的嵬)的繁体
峯	(峯	同山峰的峰)的繁体
峴	峴	港的峴	的繁体
島	島	嶼的島	的繁体
峽	峽	谷的峽	的繁体
崁	崁	頂的崁	的繁体
崄	(崄	嶮巇的嶮的簡寫)(形容山路危險)的繁体
崈	(崈	同崇拜的崇)的繁体
崋	南崋	體育會的崋	的繁体
崍	(崍	河名)的繁体
崑	崑	崙的崑	的繁体
崕	(崕	同懸崖的崖)的繁体
崗	崗	位的崗	的繁体
崙	崑崙	山的崙	的繁体
崚	崚	嶒的崚	的繁体
崟	嶔崟	的崟	的繁体
崢	崢	嶸的崢	的繁体
崯	(崯	同嶔崟的崟)的繁体
崱	崱	屴的崱	的繁体
崷	崷	山卒崢嶸的崷	的繁体
崿	坁崿	的崿	的繁体
嵂	嵂	崒的嵂	的繁体
嵎	嵎	夷的嵎	的繁体
嵐	山嵐	瘴氣的嵐	的繁体
嵑	嶱嵑	的嵑	的繁体
嵒	(嵒	即山巖)的繁体
嵓	(嵓	同岩石的岩)的繁体
嵚	(嵚	嶔崟的嶔的簡寫)的繁体
嵺	(嵺	蕭條的樣子)的繁体
嵽	(嵽	山的形狀)的繁体
嵾	(嵾	不整齊的樣子)的繁体
嶀	牧嶊嶀	膜的嶀	的繁体
嶁	(嶁	山嶺)的繁体
嶃	(嶃	嶄新的嶄的簡寫)的繁体
嶄	嶄	新的嶄	的繁体
嶇	崎嶇	的嶇	的繁体
嶊	牧嶊	嶀膜的嶊	的繁体
嶍	嶍	城的嶍	的繁体
嶒	(嶒	高峻的樣子)的繁体
嶓	嶓	家山的嶓	的繁体
嶔	嶔	崟的嶔	的繁体
嶗	(嶗	形容山險峻)的繁体
嶠	(嶠	尖而高的山)的繁体
嶡	(嶡	山崛起的樣子)的繁体
嶢	(嶢	山高的樣子)的繁体
嶧	嶧	縣的嶧	的繁体
嶮	嶮	巇(形容山路危險)的嶮	的繁体
嶲	嶲	州的嶲	的繁体
嶸	崢嶸	的嶸	的繁体
嶺	山嶺	的嶺	的繁体
嶼	島嶼	的嶼	的繁体
嶽	五嶽	的嶽	的繁体
巃	(巃	高崚)的繁体
巇	嶮巇	(形容山路危險)的巇	的繁体
巉	(巉	高山險峭的意思)的繁体
巋	(巋	小山羅列的樣子)的繁体
巒	山巒	的巒	的繁体
巓	(巓	同山巔的巔)的繁体
巔	山巔	的巔	的繁体
巖	(巖	岩石的岩的正字)的繁体
巘	(巘	山峰)的繁体
巵	(巵	同卮酒的卮)的繁体
帀	(帀	同匝道的匝)的繁体
帟	帟	國主義的帟	的繁体
帢	帢	帽的帢	的繁体
帤	(帤	大巾)的繁体
帥	元帥	的帥	的繁体
師	教師	的師	的繁体
帬	(帬	同裙子的裙)的繁体
帳	帳	幕的帳	的繁体
帶	帶	領的帶	的繁体
幀	一幀	的幀	的繁体
幃	(幃	單層的帳)的繁体
幇	(幇	同幫助的幫)的繁体
幑	(幑	同徽章的徽)的繁体
幗	巾幗	的幗	的繁体
幘	(幘	包頭髮的巾)的繁体
幚	(幚	同幫助的幫)的繁体
幟	旗幟	鮮明的幟	的繁体
幣	貨幣	的幣	的繁体
幫	幫	助的幫	的繁体
幰	(幰	車幔)的繁体
幵	(幵	開關的開的簡寫)的繁体
幷	(幷	同兼并的并)的繁体
幹	幹	部的幹	的繁体
幾	幾	多的幾	的繁体
庫	庫	房的庫	的繁体
庻	(庻	同庶民的庶)的繁体
庽	(庽	同寓所的寓)的繁体
庿	(庿	同廟宇的廟)的繁体
廁	廁	所的廁	的繁体
廂	車廂	的廂	的繁体
廄	馬廄	的廄	的繁体
廈	大廈	的廈	的繁体
廋	(廋	隱藏)的繁体
廌	(廌	古時的獨角獸)的繁体
廎	(廎	小堂屋)的繁体
廕	(廕	恩澤被及子孫)的繁体
廙	(廙	可以搬動的屋子)的繁体
廚	廚	房的廚	的繁体
廝	廝	殺的廝	的繁体
廟	廟	宇的廟	的繁体
廠	廠	商的廠	的繁体
廢	廢	物的廢	的繁体
廣	廣	闊的廣	的繁体
廩	廩	生的廩	的繁体
廬	廬	山的廬	的繁体
廳	客廳	的廳	的繁体
廵	(廵	同巡行的巡)的繁体
弇	弇	陋的弇	的繁体
弒	弒	君的弒	的繁体
弔	憑弔	的弔	的繁体
弚	(弚	同弟兄的弟)的繁体
弢	(弢	弓的袋)的繁体
弤	(弤	雕弓)的繁体
弨	(弨	弓回復原狀)的繁体
張	張	開的張	的繁体
弶	(弶	捕捉鳥獸的設備)的繁体
強	強	壯的強	的繁体
弸	弸	彋的弸	的繁体
弻	(弻	同輔弼的弼)的繁体
彄	(彄	環狀的東西)的繁体
彆	彆	扭的彆	的繁体
彈	彈	弓的彈	的繁体
彌	彌	月的彌	的繁体
彎	彎	曲的彎	的繁体
彙	詞彙	的彙	的繁体
彥	俊彥	的彥	的繁体
彫	(彫	同雕刻的雕)的繁体
彸	征彸	的彸	的繁体
彿	彷彿	的彿	的繁体
徃	(徃	同來往的往)的繁体
徑	途徑	的徑	的繁体
徛	(徛	站立)的繁体
從	從	此的從	的繁体
徠	招徠	有術的徠	的繁体
復	恢復	的復	的繁体
徬	徬	徨的徬	的繁体
徯	(徯	小路)的繁体
徹	徹	夜的徹	的繁体
徿	(徿	行事不以正當手法)的繁体
忕	(忕	習慣或慣於)的繁体
忛	(忛	同帆船的帆)的繁体
忣	(忣	同緊急的急)的繁体
忳	忳	忳	的忳	的繁体
忷	(忷	恐懼或驚駭)的繁体
忼	(忼	同慷慨的慷)的繁体
怐	怐	愁的怐	的繁体
怗	怗	服的怗	的繁体
怘	(怘	同固定的固)的繁体
怞	(怞	懮愁的意思)的繁体
怹	(怹	男性他的敬稱)的繁体
恆	恆	心的恆	的繁体
恇	(恇	害怕)的繁体
恉	意恉	的恉	的繁体
恊	(恊	同協助的協)的繁体
恓	(恓	煩惱不安的樣子)的繁体
恠	(恠	同奇怪的怪)的繁体
恡	(恡	同吝嗇的吝)的繁体
恥	恥	辱的恥	的繁体
悅	悅	耳的悅	的繁体
悊	(悊	同哲學的哲)的繁体
悋	(悋	同吝嗇的吝)的繁体
悢	(悢	惆悵)的繁体
悤	(悤	同匆忙的匆)的繁体
悰	歡悰	的悰	的繁体
悵	惆悵	的悵	的繁体
悶	悶	氣的悶	的繁体
悷	(悷	悲傷)的繁体
悽	(悽	通淒涼的淒)的繁体
悾	(悾	誠懇和忠厚的樣子)的繁体
惇	惇	誨的惇	的繁体
惈	(惈	勇敢)的繁体
惉	惉	帶的惉	的繁体
惎	惎	悔的惎	的繁体
惏	惏	慄的惏	的繁体
惓	(惓	忠誠和懇切)的繁体
惖	(惖	同警惕的惕)的繁体
惙	惙	怛的惙	的繁体
惛	惛	眊的惛	的繁体
惡	兇惡	的惡	的繁体
惣	(惣	同總結的總)的繁体
惥	(惥	同慫恿的恿)的繁体
惪	(惪	同道德的德)的繁体
惱	煩惱	的惱	的繁体
惲	惲	敬的惲	的繁体
惷	(惷	同愚蠢的蠢)的繁体
惸	憂心惸	惸	的惸	的繁体
惻	惻	隱的惻	的繁体
惽	(惽	同惛眊的惛)的繁体
愊	愊	憶(心中鬱結)的愊	的繁体
愓	愓	布的愓	的繁体
愔	愔	愔	的愔	的繁体
愘	(愘	同恪守的恪)的繁体
愙	(愙	同恪守的恪)的繁体
愛	愛	好的愛	的繁体
愜	愜	意的愜	的繁体
愨	(愨	誠實)的繁体
愬	薄言往愬	的愬	的繁体
愴	悲愴	的愴	的繁体
愷	(愷	歡樂)的繁体
愼	(愼	同謹慎的慎)的繁体
愽	(愽	同博士的博)的繁体
愾	同仇敵愾	的愾	的繁体
慁	(慁	憂患)的繁体
慄	顫慄	的慄	的繁体
慅	(慅	同騷擾的騷)的繁体
慆	(慆	快樂之意)的繁体
慇	慇	懃(含有敬意)的慇	的繁体
慉	(慉	憤恨的意思)的繁体
態	態	度的態	的繁体
慍	(慍	心含怨怒)的繁体
慓	慓	悍的慓	的繁体
慘	悲慘	的慘	的繁体
慙	(慙	同慚愧的慚)的繁体
慚	慚	愧的慚	的繁体
慞	慞	惶的慞	的繁体
慟	慟	哭的慟	的繁体
慠	(慠	同驕傲的傲)的繁体
慣	習慣	的慣	的繁体
慤	夏慤	道的慤	的繁体
慥	(慥	言行急)的繁体
慪	氣慪	的慪	的繁体
慫	慫	恿的慫	的繁体
慬	(慬	勇氣)的繁体
慮	考慮	的慮	的繁体
慯	(慯	同傷害的傷)的繁体
慱	(慱	圓滿)的繁体
慳	慳	錢的慳	的繁体
慴	(慴	畏懼)的繁体
慶	慶	祝的慶	的繁体
慺	(慺	歡悅)的繁体
慼	慼	慼	然的慼	的繁体
慽	(慽	同親戚的戚)的繁体
慾	慾	望的慾	的繁体
憀	(憀	賴)的繁体
憂	憂	愁的憂	的繁体
憇	(憇	同休憩的憩)的繁体
憊	疲憊	的憊	的繁体
憐	可憐	的憐	的繁体
憑	文憑	的憑	的繁体
憚	忌憚	的憚	的繁体
憤	憤	怒的憤	的繁体
憫	憐憫	的憫	的繁体
憮	憮	然的憮	的繁体
憲	憲	法的憲	的繁体
憶	回憶	的憶	的繁体
憸	(憸	奸詐)的繁体
懃	慇懃	(含有敬意)的懃	的繁体
懇	誠懇	的懇	的繁体
應	應	該的應	的繁体
懍	懍	然的懍	的繁体
懜	(懜	同懵懂的懵)的繁体
懟	怨懟	的懟	的繁体
懣	憤懣	的懣	的繁体
懩	(懩	同痕癢的癢)的繁体
懲	懲	罰的懲	的繁体
懶	懶	惰的懶	的繁体
懷	懷	念的懷	的繁体
懸	懸	掛的懸	的繁体
懺	懺	悔的懺	的繁体
懼	恐懼	的懼	的繁体
懾	懾	服的懾	的繁体
戀	戀	愛的戀	的繁体
戅	(戅	同戇直的戇)的繁体
戇	戇	直的戇	的繁体
戔	戔	戔	微物的戔	的繁体
戞	(戞	同戛木的戛)的繁体
戣	(戣	一種古兵器)的繁体
戩	戩	穀的戩	的繁体
戯	(戯	同戲劇的戲)的繁体
戰	戰	爭的戰	的繁体
戱	(戱	同戲劇的戲)的繁体
戲	戲	劇的戲	的繁体
戶	戶	口的戶	的繁体
戹	(戹	同厄運的厄)的繁体
戼	(戼	同卯時的卯)的繁体
扐	(扐	手指之間)的繁体
扞	扞	禦的扞	的繁体
扠	(扠	以叉刺取)的繁体
扱	扱	取(撿取)的扱	的繁体
扵	(扵	同於是的於)的繁体
扺	扺	達的扺	的繁体
扽	扽	平的扽	的繁体
抆	抆	血相視的抆	的繁体
抔	抔	飲的抔	的繁体
抝	(抝	同拗氣的拗)的繁体
抭	(抭	同舀水的舀)的繁体
拋	拋	棄的拋	的繁体
拏	(拏	同拿東西的拿)的繁体
拑	拑	制的拑	的繁体
拕	(拕	同拖拉的拖)的繁体
拪	(拪	同遷居的遷)的繁体
挌	(挌	同性格的格)的繁体
挓	(挓	張開)的繁体
挔	(挔	同旅行的旅)的繁体
挵	(挵	同玩弄的弄)的繁体
挼	(挼	皺縮)的繁体
挾	挾	持的挾	的繁体
捓	(捓	同揶揄的揶)的繁体
捙	(捙	同拽住的拽)的繁体
捥	捥	骨的捥	的繁体
捦	(捦	同擒拿的擒)的繁体
捨	捨	棄的捨	的繁体
捫	捫	心自問的捫	的繁体
捲	捲	起的捲	的繁体
捴	(捴	同總結的總)的繁体
捵	捵	銷的捵	的繁体
捼	摩捼	的捼	的繁体
捽	(捽	用手揪或拔的意思)的繁体
掃	掃	地的掃	的繁体
掄	掄	起的掄	的繁体
掔	(掔	牽引的意思)的繁体
掗	(掗	迫人要不願要的東西)的繁体
掙	掙	扎的掙	的繁体
掛	懸掛	的掛	的繁体
掞	(掞	舒發)的繁体
掟	掟	煲的掟	的繁体
採	採	用的採	的繁体
掤	掤	扒的掤	的繁体
掫	(掫	巡夜打更)的繁体
掯	勒掯	的掯	的繁体
掱	(掱	扒手的意思)的繁体
掽	(掽	同踫撞的踫)的繁体
揀	揀	選的揀	的繁体
揃	揃	平的揃	的繁体
揅	(揅	研究之意)的繁体
揔	(揔	同總結的總)的繁体
揕	(揕	刺或打)的繁体
揚	發揚	的揚	的繁体
換	交換	的換	的繁体
揜	揜	目的揜	的繁体
揝	(揝	手抖動的樣子)的繁体
揫	(揫	斂棄)的繁体
揮	揮	手的揮	的繁体
揵	(揵	使其能牢固握住)的繁体
揷	(揷	同插花的插)的繁体
揹	揹	負的揹	的繁体
揼	揼	完的揼	的繁体
搆	搆	取的搆	的繁体
搇	(搇	同撳鈴的撳)的繁体
搉	商榷(商量)的搉	的繁体
搊	搊	彈的搊	的繁体
損	損	失的損	的繁体
搎	捫搎	的搎	的繁体
搒	(搒	划船)的繁体
搕	搕	煙袋鍋子的搕	的繁体
搖	搖	擺的搖	的繁体
搗	搗	亂的搗	的繁体
搘	搘	拄的搘	的繁体
搚	(搚	拉折東西的聲音)的繁体
搢	搢	笏的搢	的繁体
搤	(搤	扼要)的繁体
搥	(搥	同捶胸的捶)的繁体
搧	搧	動的搧	的繁体
搨	搨	本的搨	的繁体
搯	(搯	掏出來)的繁体
搰	(搰	挖掘)的繁体
搳	搳	拳的搳	的繁体
搵	搵	笨的搵	的繁体
搶	搶	劫的搶	的繁体
搷	(搷	敲擊)的繁体
搾	搾	取的搾	的繁体
摀	摀	住的摀	的繁体
摃	(摃	同扛起的扛)的繁体
摋	(摋	側手擊打)的繁体
摎	(摎	縛殺)的繁体
摐	(摐	撞擊)的繁体
摑	掌摑	的摑	的繁体
摓	(摓	同縫紉的縫)的繁体
摛	(摛	發布)的繁体
摜	(摜	把東西摔在地)的繁体
摟	摟	着羊皮的狼的摟	的繁体
摠	(摠	結合)的繁体
摣	(摣	同揸車的揸)的繁体
摮	摮	邯的摮	的繁体
摯	真摯	的摯	的繁体
摰	(摰	危險不安)的繁体
摲	(摲	斬除)的繁体
摳	(摳	手指挖取)的繁体
摴	(摴	古代賭博的遊戲)的繁体
摵	(摵	葉落的聲音)的繁体
摶	(摶	用手將東西揉成一團)的繁体
摻	(摻	同攙扶的攙)的繁体
摽	(摽	指揮)的繁体
撆	(撆	同撇除的撇)的繁体
撈	撈	起的撈	的繁体
撐	撐	腰的撐	的繁体
撓	阻撓	的撓	的繁体
撘	撘	訕的撘	的繁体
撚	撚	骨的撚	的繁体
撝	撝	挹的撝	的繁体
撡	(撡	同操練的操)的繁体
撢	撢	掃的撢	的繁体
撥	挑撥	的撥	的繁体
撦	(撦	同扯)的繁体
撫	撫	摩的撫	的繁体
撲	撲	滅的撲	的繁体
撳	撳	鈴的撳	的繁体
撻	鞭撻	的撻	的繁体
撿	撿	拾的撿	的繁体
擁	擁	護的擁	的繁体
擄	擄	劫的擄	的繁体
擇	選擇	的擇	的繁体
擊	打擊	的擊	的繁体
擋	阻擋	的擋	的繁体
擏	(擏	同引擎的擎)的繁体
擑	(擑	同接觸的接)的繁体
擔	擔	當的擔	的繁体
據	證據	的據	的繁体
擠	擠	迫的擠	的繁体
擥	(擥	同招攬的攬)的繁体
擬	擬	定的擬	的繁体
擭	應擭	的擭	的繁体
擯	擯	棄的擯	的繁体
擰	擰	頭的擰	的繁体
擱	擱	置的擱	的繁体
擲	拋擲	的擲	的繁体
擴	擴	大的擴	的繁体
擷	擷	取的擷	的繁体
擺	擺	動的擺	的繁体
擻	抖擻	的擻	的繁体
擾	擾	亂的擾	的繁体
攂	(攂	同擂台的擂)的繁体
攆	攆	走的攆	的繁体
攏	靠攏	的攏	的繁体
攔	攔	阻的攔	的繁体
攖	攖	怒(接觸或觸犯)的攖	的繁体
攙	攙	扶的攙	的繁体
攛	(攛	匆忙做事)的繁体
攜	攜	同的攜	的繁体
攝	攝	影的攝	的繁体
攞	攞	獎的攞	的繁体
攢	攢	眉的攢	的繁体
攣	痙攣	的攣	的繁体
攤	攤	檔的攤	的繁体
攪	攪	亂的攪	的繁体
攬	招攬	的攬	的繁体
攲	攲	案的攲	的繁体
攷	(攷	同考試的考)的繁体
敁	(敁	斟酌)的繁体
敂	(敂	同叩頭的叩)的繁体
敍	敍	述的敍	的繁体
敓	(敓	奪取的奪的本字)的繁体
敔	柷敔	的敔	的繁体
敗	失敗	的敗	的繁体
敘	敘	述的敘	的繁体
敚	(敚	同爭奪的奪)的繁体
敩	(敩	學習的學的簡寫)的繁体
敭	(敭	同發揚的揚)的繁体
敵	敵	人的敵	的繁体
數	數	學的數	的繁体
斂	收斂	的斂	的繁体
斃	斃	命的斃	的繁体
斆	(斆	同學習的學)的繁体
斒	斒	斕的斒	的繁体
斕	斑斕	的斕	的繁体
斚	(斚	同斝歷的斝)的繁体
斝	斝	歷的斝	的繁体
斞	(斞	同庾澄慶的庾)的繁体
斠	(斠	平斗斛)的繁体
斬	斬	斷的斬	的繁体
斮	(斮	斬)的繁体
斲	(斲	砍木)的繁体
斳	(斳	同芹菜的芹)的繁体
斷	中斷	的斷	的繁体
旂	(旂	旗幟)的繁体
旉	(旉	同敷衍的敷)的繁体
旍	(旍	同旌旗蔽日的旌)的繁体
旐	(旐	旗的一種)的繁体
旝	(旝	古時戰爭發石子的車)的繁体
旡	旡	咎的旡	的繁体
旤	(旤	同禍害的禍)的繁体
旳	(旳	同我的的的)的繁体
旴	(旴	太陽剛出來的樣子)的繁体
旸	(旸	暘谷的暘的簡寫)的繁体
旹	(旹	同時間的時)的繁体
旻	(旻	秋天或天空)的繁体
旾	(旾	同春天的春)的繁体
昇	昇	華的昇	的繁体
昒	昒	昕的昒	的繁体
昚	(昚	同謹慎的慎)的繁体
昜	(昜	同太陽的陽)的繁体
昤	昤	孵的昤	的繁体
昦	(昦	同昊青的昊)的繁体
昫	(昫	短時間)的繁体
昬	(昬	同昏暗的昏)的繁体
昳	(昳	日過午後偏斜)的繁体
昺	(昺	光明)的繁体
昽	(昽	矇矓的曨的簡寫)(剛日出光線暗淡不明)的繁体
時	時	間的時	的繁体
晅	(晅	太陽四周的暈氣)的繁体
晈	(晈	同皎潔的皎)的繁体
晉	晉	升的晉	的繁体
晛	(晛	太陽的熱氣)的繁体
晝	晝	夜的晝	的繁体
晞	(晞	乾燥)的繁体
晬	晬	盤的晬	的繁体
晻	晻	世的晻	的繁体
晼	(晼	太陽將落的樣子)的繁体
暀	(暀	同旺盛的旺)的繁体
暈	暈	倒的暈	的繁体
暉	春暉	的暉	的繁体
暎	(暎	同放映的映)的繁体
暐	(暐	日光)的繁体
暘	暘	谷的暘	的繁体
暠	(暠	明瞭)的繁体
暢	暢	快的暢	的繁体
暫	暫	時的暫	的繁体
暱	(暱	同親昵的昵)的繁体
暸	暸	解的暸	的繁体
曁	(曁	同暨所屬的暨)的繁体
曄	小曄	的曄	的繁体
曆	農曆	的曆	的繁体
曇	曇	花的曇	的繁体
曉	曉	得的曉	的繁体
曖	曖	昧的曖	的繁体
曠	曠	課的曠	的繁体
曡	(曡	同叠翠豪庭的叠)的繁体
曨	矇矓(剛日出光線暗淡不明)的曨	的繁体
曬	曬	太陽的曬	的繁体
曱	曱	甴的曱	的繁体
曵	(曵	同搖曳的曳)的繁体
書	書	本的書	的繁体
會	會	議的會	的繁体
朓	栴朓	的朓	的繁体
朘	(朘	男孩的生殖器)的繁体
朙	(朙	同明白的明)的繁体
朧	朦朧	的朧	的繁体
朮	朮	赤的朮	的繁体
朶	(朶	同花朵的朵)的繁体
朸	(朸	植物名)的繁体
朿	(朿	木芒)的繁体
杕	杕	杜的杕	的繁体
杙	(杙	小木樁)的繁体
杝	(杝	木名)的繁体
東	東	方的東	的繁体
杴	(杴	農具)的繁体
杶	(杶	植物名)的繁体
枀	(枀	同松樹的松)的繁体
枌	(枌	植物名)的繁体
枏	(枏	同楠樹的楠)的繁体
枑	梐枑	(木做的路障)的枑	的繁体
枒	枒	枝的枒	的繁体
枓	枓	栱的枓	的繁体
枱	枱	面的枱	的繁体
枲	(枲	不結子的大蔴)的繁体
枴	枴	杖的枴	的繁体
枹	(枹	打鼓之槌)的繁体
柈	(柈	大塊的木柴)的繁体
柟	(柟	同楠樹的楠)的繁体
柮	榾柮	的柮	的繁体
柵	欄柵	的柵	的繁体
柷	柷	敔的柷	的繁体
柺	(柺	同拐帶的拐)的繁体
査	(査	同查詢的查)的繁体
栒	(栒	縣名)的繁体
栞	(栞	同刊物的刊)的繁体
栟	(栟	地名)的繁体
栢	張栢	芝(人名)的栢	的繁体
栰	(栰	同木筏的筏)的繁体
栱	枓栱	的栱	的繁体
栴	栴	朓的栴	的繁体
桒	(桒	同桑田的桑)的繁体
桚	(桚	同壓拶子的拶)的繁体
桮	(桮	同杯葛的杯)的繁体
桰	(桰	同檜樹的栝)的繁体
桲	(桲	打穀器)的繁体
桹	(桹	檳榔的榔的本體字)的繁体
桺	(桺	同楊柳的柳)的繁体
桼	桼	水的桼	的繁体
桿	槓桿	的桿	的繁体
梐	梐	枑(木做的路障)的梐	的繁体
梔	梔	子的梔	的繁体
梖	(梖	同貝殼的貝)的繁体
梘	香梘	的梘	的繁体
條	條	件的條	的繁体
梟	梟	雄的梟	的繁体
梩	(梩	鍬臿一類的起土用具)的繁体
梫	梫	木的梫	的繁体
梱	(梱	在門中豎短木為門限)的繁体
梲	梲	拾的梲	的繁体
梴	(梴	樹木高長的樣子)的繁体
梹	(梹	同檳榔的檳)的繁体
梼	(梼	檮昧的檮的簡寫)的繁体
梿	(梿	榴槤的槤的簡寫)(水果)的繁体
棄	放棄	的棄	的繁体
棊	(棊	同象棋的棋)的繁体
棐	(棐	盛物用的竹器)的繁体
棓	(棓	打榖的器具)的繁体
棖	棖	觸的棖	的繁体
棗	紅棗	的棗	的繁体
棟	棟	樑的棟	的繁体
棡	(棡	橫牆木)的繁体
棧	棧	道的棧	的繁体
棨	棨	信的棨	的繁体
棫	棫	樸的棫	的繁体
棬	桮棬	的棬	的繁体
棲	棲	息的棲	的繁体
棳	(棳	樹名)的繁体
棷	(棷	木薪)的繁体
椄	(椄	與接受的接通用)的繁体
椇	(椇	樹木名)的繁体
椈	(椈	樹木名)的繁体
椉	(椉	同乘坐的乘)的繁体
椌	椌	楬的椌	的繁体
椏	樹椏	的椏	的繁体
椑	椑	柿的椑	的繁体
椓	(椓	古代去人陰部的宮刑)的繁体
椘	(椘	同清楚的楚)的繁体
椝	(椝	規則的規的簡寫)的繁体
椳	(椳	門的旋軸)的繁体
椷	(椷	書信)的繁体
椸	(椸	衣架)的繁体
椻	甪里椻	的椻	的繁体
椾	(椾	同信箋的箋)的繁体
楀	(楀	木名)的繁体
楅	楅	衡的楅	的繁体
楈	楈	枒的楈	的繁体
楊	楊	柳的楊	的繁体
楎	(楎	掛衣服的架)的繁体
楓	楓	葉的楓	的繁体
楕	(楕	同橢圓形的橢)的繁体
楘	(楘	車轅上的皮革做的飾物)的繁体
楙	(楙	林木茂盛的樣子)的繁体
楛	楛	樹的楛	的繁体
楟	(楟	植物名)的繁体
楥	楥	葎的楥	的繁体
楨	楨	幹的楨	的繁体
楩	楩	柄的楩	的繁体
楬	椌楬	的楬	的繁体
業	職業	的業	的繁体
楯	楯	無的楯	的繁体
楳	(楳	同梅花的梅)的繁体
極	極	端的極	的繁体
榎	(榎	植物名)的繁体
榖	(榖	穀物的穀的香港寫法)的繁体
榙	榙	樏的榙	的繁体
榤	(榤	古兵器)的繁体
榮	榮	譽的榮	的繁体
榯	(榯	木直豎的樣子)的繁体
榾	榾	柮的榾	的繁体
榿	(榿	植物名)的繁体
槀	(槀	同枯槁的槁)的繁体
槈	(槈	同耘耨的耨)的繁体
構	構	造的構	的繁体
槍	槍	砲的槍	的繁体
槓	雙槓	的槓	的繁体
槕	(槕	同桌椅的桌)的繁体
槖	(槖	同橐駝的橐)的繁体
槤	榴槤	(水果)的槤	的繁体
槩	(槩	同概況的概)的繁体
槪	(槪	同概況的概)的繁体
槳	螺旋槳	的槳	的繁体
樁	打樁	的樁	的繁体
樂	快樂	的樂	的繁体
樅	(樅	常綠喬木)的繁体
樏	榙樏	的樏	的繁体
樐	(樐	同搖櫓的櫓)的繁体
樑	橋樑	的樑	的繁体
樓	樓	房的樓	的繁体
標	標	準的標	的繁体
樞	樞	紐的樞	的繁体
樣	樣	子的樣	的繁体
樷	(樷	同叢林的叢)的繁体
樸	樸	素的樸	的繁体
樹	樹	木的樹	的繁体
樺	白樺	樹的樺	的繁体
樼	(樼	同榛園的榛)的繁体
橁	(橁	同椿樹的椿)的繁体
橈	橈	足的橈	的繁体
橋	橋	樑的橋	的繁体
橜	(橜	同橛子的橛)的繁体
機	機	械的機	的繁体
橢	橢	圓形的橢	的繁体
橤	(橤	同花蕊的蕊)的繁体
橫	縱橫	的橫	的繁体
橾	(車轂中空稱為橾	)的繁体
檉	檉	柳(植物名)的檉	的繁体
檔	檔	案的檔	的繁体
檜	檜	樹的檜	的繁体
檢	檢	查的檢	的繁体
檣	檣	帆的檣	的繁体
檮	檮	昧的檮	的繁体
檯	檯	椅的檯	的繁体
檳	檳	榔的檳	的繁体
檸	檸	檬的檸	的繁体
檻	門檻	的檻	的繁体
櫃	櫃	桶的櫃	的繁体
櫄	(櫄	同椿樹的椿)的繁体
櫈	櫈	仔的櫈	的繁体
櫍	(櫍	古時殺人的刑具)的繁体
櫑	櫑	劍的櫑	的繁体
櫓	搖櫓	的櫓	的繁体
櫚	棕櫚	(樹名)的櫚	的繁体
櫛	櫛	風沐雨的櫛	的繁体
櫜	(櫜	收藏兵甲弓矢的套子)的繁体
櫝	(櫝	棺材)的繁体
櫞	枸櫞	(果名)的櫞	的繁体
櫟	(櫟	植物名)的繁体
櫥	櫥	窗的櫥	的繁体
櫧	(櫧	植物名)的繁体
櫨	黃櫨	(落葉灌木)的櫨	的繁体
櫪	老驥伏櫪	的櫪	的繁体
櫫	揭櫫	的櫫	的繁体
櫬	(櫬	棺材)的繁体
櫳	房櫳	的櫳	的繁体
櫸	櫸	木的櫸	的繁体
櫺	窗櫺	的櫺	的繁体
櫻	櫻	花的櫻	的繁体
櫼	(櫼	上尖下平的楔子)的繁体
櫾	(櫾	同柚木的柚)的繁体
欄	欄	杆的欄	的繁体
權	權	力的權	的繁体
欏	桫欏	的欏	的繁体
欐	(欐	樑梗)的繁体
欒	欒	提的欒	的繁体
欖	橄欖	的欖	的繁体
欛	(欛	同把手的把)的繁体
欝	(欝	同鬱悶的鬱)的繁体
欬	(欬	同咳嗽的咳)的繁体
欱	(欱	同喝水的喝)的繁体
欸	(欸	答應或嗟歎之聲)的繁体
欻	欻	吸的欻	的繁体
欽	欽	佩的欽	的繁体
欿	欿	傺的欿	的繁体
歈	吳歈	的歈	的繁体
歎	慨歎	的歎	的繁体
歐	歐	洲的歐	的繁体
歛	歛	財的歛	的繁体
歟	然歟	的歟	的繁体
歠	餔歠	(喝飲)的歠	的繁体
歡	歡	喜的歡	的繁体
歩	(歩	同步行的步)的繁体
歬	(歬	同前後的前)的繁体
歱	(歱	同接踵而來的踵)的繁体
歲	歲	月的歲	的繁体
歴	(歴	同歷史的歷)的繁体
歷	歷	史的歷	的繁体
歸	歸	還的歸	的繁体
歿	隕歿	的歿	的繁体
殀	(殀	夭折)的繁体
殘	傷殘	的殘	的繁体
殞	殞	命的殞	的繁体
殠	(殠	同臭味的臭)的繁体
殢	尤雲殢	雨的殢	的繁体
殭	殭	屍的殭	的繁体
殮	殮	房的殮	的繁体
殯	殯	儀的殯	的繁体
殰	(殰	動物的胎在腹中敗壞)的繁体
殲	殲	滅的殲	的繁体
殶	(殶	同注意的注)的繁体
殺	殺	人的殺	的繁体
殼	貝殼	的殼	的繁体
殽	殽	亂的殽	的繁体
毀	毀	滅的毀	的繁体
毆	毆	打的毆	的繁体
毌	(毌	同毋須有的毋)的繁体
毘	毘	沙門天的毘	的繁体
毧	(毧	同絨毛的絨)的繁体
毬	毬	果的毬	的繁体
毸	毰毸	的毸	的繁体
氂	氂	牛的氂	的繁体
氈	毛氈	的氈	的繁体
氊	(氊	同毛氈的氈)的繁体
氌	氆氌	的氌	的繁体
氣	氣	體的氣	的繁体
氥	(氥	化學元素)的繁体
氫	(氫	化學元素)的繁体
氬	(氬	化學元素)的繁体
氭	(氭	同氡氣的氡)的繁体
氳	霧氣氤氳	的氳	的繁体
氹	氹	仔的氹	的繁体
氾	氾	濫的氾	的繁体
氿	氿	泉的氿	的繁体
汍	汍	瀾(流淚的樣子)的汍	的繁体
汎	(汎	同廣泛的泛)的繁体
汒	(汒	同茫茫的茫)的繁体
汙	(汙	骯髒的意思)的繁体
汧	汧	陽的汧	的繁体
汭	(汭	河流會合處或彎曲處)的繁体
汳	(汳	同汴京的汴)的繁体
汸	(汸	水勢盛大意思)的繁体
決	決	定的決	的繁体
沍	(沍	閉塞)的繁体
沒	沒	有的沒	的繁体
沖	沖	茶的沖	的繁体
沚	(沚	水中的小塊陸地)的繁体
沜	(沜	同泮池的泮)的繁体
沬	沬	血的沬	的繁体
沴	沴	孽的沴	的繁体
沵	(沵	沴孽的沴的簡寫)的繁体
況	情況	的況	的繁体
泂	(泂	形容水清深廣)的繁体
泃	泃	河的泃	的繁体
泆	(泆	河水四溢)的繁体
泚	(泚	鮮明)的繁体
泝	(泝	逆流而上)的繁体
洑	洑	水的洑	的繁体
洨	(洨	河北省水名)的繁体
洩	(洩	泄漏的泄的常用字)的繁体
洭	(洭	廣東省水名)的繁体
洴	洴	澼的洴	的繁体
洶	洶	湧的洶	的繁体
洸	(洸	水波動蕩)的繁体
洺	洺	水的洺	的繁体
浥	(浥	濕潤)的繁体
浬	海浬	的浬	的繁体
浹	汗流浹	背的浹	的繁体
涇	涇	河的涇	的繁体
涊	涊	寨的涊	的繁体
涳	涳	濛的涳	的繁体
涴	涴	演的涴	的繁体
涷	(涷	暴雨)的繁体
涼	涼	快的涼	的繁体
淈	(淈	攪濁)的繁体
淒	淒	涼的淒	的繁体
淚	眼淚	的淚	的繁体
淛	(淛	同浙江的浙)的繁体
淜	(淜	涉水過河)的繁体
淟	(淟	污垢)的繁体
淢	(淢	急流)的繁体
淥	(淥	清澈)的繁体
淨	乾淨	的淨	的繁体
淩	(淩	同凌亂的凌)的繁体
淪	淪	落的淪	的繁体
淯	(淯	河流名)的繁体
淵	深淵	的淵	的繁体
淶	(淶	縣名)的繁体
淸	(淸	同清潔的清)的繁体
淺	深淺	的淺	的繁体
渉	(渉	同干涉的涉)的繁体
渙	渙	散的渙	的繁体
減	減	少的減	的繁体
渜	(渜	溫水)的繁体
渟	渟	水的渟	的繁体
渦	漩渦	的渦	的繁体
渨	渨	水的渨	的繁体
測	測	驗的測	的繁体
渰	渰	淒淒的渰	的繁体
渾	渾	身的渾	的繁体
湉	湉	湉	的湉	的繁体
湊	湊	合的湊	的繁体
湋	湋	水的湋	的繁体
湌	(湌	同餐廳的餐)的繁体
湑	(湑	濾過的酒)的繁体
湙	湙	在鈕扣中的湙	的繁体
湜	湜	水的湜	的繁体
湝	淮水湝	湝	的湝	的繁体
湞	湞	水的湞	的繁体
湢	湢	仄的湢	的繁体
湣	(湣	混亂的樣子)的繁体
湧	洶湧	的湧	的繁体
湩	乳湩	有餘的湩	的繁体
湯	煲湯	的湯	的繁体
湲	潺湲	的湲	的繁体
湻	(湻	同淳樸的淳)的繁体
湼	(湼	同涅盤的涅)的繁体
溈	溈	水的溈	的繁体
溎	(溎	大水)的繁体
溔	灝溔	的溔	的繁体
準	準	備的準	的繁体
溝	溝	渠的溝	的繁体
溠	溠	水的溠	的繁体
溦	(溦	小雨)的繁体
溫	溫	暖的溫	的繁体
溮	(溮	水名亦稱楊柳河)的繁体
溼	(溼	同濕潤的濕)的繁体
滀	(滀	鬱結)的繁体
滃	(滃	雲或霧湧起的樣子)的繁体
滄	滄	桑的滄	的繁体
滅	滅	亡的滅	的繁体
滆	滆	湖的滆	的繁体
滈	滈	汗的滈	的繁体
滌	洗滌	的滌	的繁体
滍	(滍	高而潔白的樣子)的繁体
滎	滎	陽的滎	的繁体
滘	滘	西洲的滘	的繁体
滙	(滙	同匯款的匯)的繁体
滛	(滛	同淫邪的淫)的繁体
滪	(滪	灩澦堆的澦的簡寫)的繁体
滫	(滫	米汁)的繁体
滬	(滬	上海的簡稱)的繁体
滯	停滯	的滯	的繁体
滲	滲	透的滲	的繁体
滷	鹽滷	的滷	的繁体
滸	水滸	傳的滸	的繁体
滾	滾	動的滾	的繁体
滿	滿	意的滿	的繁体
漁	漁	翁的漁	的繁体
漈	(漈	涯際)的繁体
漊	(漊	小雨下不停)的繁体
漑	(漑	同灌溉的溉)的繁体
漘	(漘	水邊)的繁体
漙	(漙	露水多)的繁体
漚	漚	鳥的漚	的繁体
漢	漢	字的漢	的繁体
漣	漣	漪的漣	的繁体
漧	(漧	同乾淨的乾)的繁体
漬	水漬	的漬	的繁体
漲	高漲	的漲	的繁体
漸	逐漸	的漸	的繁体
漿	漿	糊的漿	的繁体
潀	(潀	小水溶入大水)的繁体
潁	潁	川的潁	的繁体
潑	活潑	的潑	的繁体
潔	清潔	的潔	的繁体
潛	潛	能的潛	的繁体
潟	潟	湖的潟	的繁体
潠	(潠	噴水之意)的繁体
潤	潤	滑的潤	的繁体
潯	潯	陽的潯	的繁体
潰	潰	爛的潰	的繁体
澀	苦澀	的澀	的繁体
澁	(澁	同苦澀的澀)的繁体
澂	(澂	同澄清的澄)的繁体
澆	澆	水的澆	的繁体
澇	澇	災的澇	的繁体
澔	澔	威的澔	的繁体
澗	溪澗	的澗	的繁体
澘	(澘	同潸潸落淚的潸)的繁体
澤	光澤	的澤	的繁体
澦	灩澦	堆的澦	的繁体
澫	(澫	同浪漫的漫)的繁体
澰	(澰	同瀲灩的瀲)的繁体
澱	澱	粉的澱	的繁体
澴	澴	瀯的澴	的繁体
澼	洴澼	的澼	的繁体
濁	污濁	的濁	的繁体
濃	濃	淡的濃	的繁体
濄	(濄	同漩渦的渦)的繁体
濕	濕	潤的濕	的繁体
濘	泥濘	的濘	的繁体
濛	濛	濛	細雨的濛	的繁体
濟	救濟	的濟	的繁体
濤	波濤	的濤	的繁体
濩	(濩	烹煮)的繁体
濫	濫	用的濫	的繁体
濬	疏濬	河道的濬	的繁体
濰	濰	河的濰	的繁体
濱	海濱	的濱	的繁体
濶	(濶	同寬闊的闊)的繁体
濺	濺	濕的濺	的繁体
濾	濾	水器的濾	的繁体
瀁	(瀁	同蕩漾的漾)的繁体
瀆	褻瀆	的瀆	的繁体
瀉	瀉	藥的瀉	的繁体
瀋	瀋	陽的瀋	的繁体
瀏	瀏	覽的瀏	的繁体
瀕	瀕	臨絕境的瀕	的繁体
瀘	瀘	州的瀘	的繁体
瀝	瀝	青的瀝	的繁体
瀟	瀟	洒的瀟	的繁体
瀠	瀠	洄的瀠	的繁体
瀡	滫瀡	(濕滑)的瀡	的繁体
瀦	瀦	留的瀦	的繁体
瀧	瀧	川一益的瀧	的繁体
瀨	(瀨	沙石上流過的湍流)的繁体
瀯	澴瀯	的瀯	的繁体
瀰	瀰	漫的瀰	的繁体
瀲	(瀲	水邊)的繁体
瀼	瀼	瀼	(形容露水很多)的瀼	的繁体
瀾	狂瀾	的瀾	的繁体
灃	載灃	的灃	的繁体
灋	(灋	同法律的法)的繁体
灑	灑	水的灑	的繁体
灕	灕	江的灕	的繁体
灘	海灘	的灘	的繁体
灝	(灝	浩大或廣遠)的繁体
灠	(灠	用調味品拌)的繁体
灡	(灡	同狂瀾的瀾)的繁体
灣	海灣	的灣	的繁体
灤	灤	河的灤	的繁体
灨	灨	江(河名)的灨	的繁体
灩	灩	灩	(水波映光奪目)的灩	的繁体
灺	(灺	蠟燭燒剩下的部份)的繁体
災	災	禍的災	的繁体
炆	炆	牛腩的炆	的繁体
炘	火光炘	炘	的炘	的繁体
炤	(炤	同照耀的照)的繁体
炰	(炰	烹調方法)的繁体
為	為	甚麼的為	的繁体
烏	烏	黑的烏	的繁体
烔	熱氣烔	烔	的烔	的繁体
烚	烚	熟的烚	的繁体
烜	烜	赫的烜	的繁体
烝	(烝	眾多)的繁体
烰	烰	人的烰	的繁体
烱	張達烱	的烱	的繁体
烴	烯烴	的烴	的繁体
烺	(烺	火光明亮)的繁体
焂	(焂	疾速或忽然)的繁体
焌	(焌	點火)的繁体
焗	焗	爐的焗	的繁体
焜	焜	耀的焜	的繁体
焠	焠	掌的焠	的繁体
無	有無	的無	的繁体
焮	焮	天的焮	的繁体
焴	(焴	同李煜的煜)的繁体
煆	煆	煆	霸霸的煆	的繁体
煇	(煇	太陽周圍的光圈)的繁体
煉	煉	鋼的煉	的繁体
煑	(煑	同煮飯的煮)的繁体
煒	(煒	人名用)的繁体
煖	煖	房的煖	的繁体
煗	(煗	同暖和的暖)的繁体
煙	煙	霧的煙	的繁体
煢	煢	居的煢	的繁体
煥	煥	發的煥	的繁体
煩	煩	惱的煩	的繁体
煬	隋煬	帝的煬	的繁体
熀	煒熀	的熀	的繁体
熅	(熅	微火)的繁体
熈	(熈	同熙來攘往的熙)的繁体
熒	熒	光屏的熒	的繁体
熱	熱	心的熱	的繁体
熺	(熺	同朱熹的熹)的繁体
熾	熾	熱的熾	的繁体
燁	燁	隆的燁	的繁体
燄	(燄	同火焰的焰)的繁体
燈	燈	光的燈	的繁体
燉	燉	冬菇的燉	的繁体
燊	燊	達的燊	的繁体
燌	(燌	同焚燒的焚)的繁体
燐	燐	火的燐	的繁体
燒	燒	毀的燒	的繁体
燙	燙	手的燙	的繁体
燜	燜	燒的燜	的繁体
營	營	養的營	的繁体
燦	燦	爛的燦	的繁体
燬	焚燬	的燬	的繁体
燭	燭	光的燭	的繁体
燴	燴	意粉的燴	的繁体
燻	煙燻	的燻	的繁体
燼	灰燼	的燼	的繁体
燾	拓跋燾	(人名)的燾	的繁体
燿	燿	華電子的燿	的繁体
爇	爇	櫬的爇	的繁体
爊	(爊	溫或煨)的繁体
爍	閃爍	的爍	的繁体
爐	火爐	的爐	的繁体
爗	(爗	同燁隆的燁)的繁体
爛	破爛	的爛	的繁体
爞	(爞	同熱氣烔烔的烔)的繁体
爭	戰爭	的爭	的繁体
爺	老爺	的爺	的繁体
爾	偶爾	的爾	的繁体
牀	牀	鋪的牀	的繁体
牆	牆	壁的牆	的繁体
牉	牉	合的牉	的繁体
牋	牋	奏的牋	的繁体
牎	(牎	同窗戶的窗)的繁体
牏	廁牏	的牏	的繁体
牐	(牐	同閘門的閘)的繁体
牓	(牓	同榜樣的榜)的繁体
牘	尺牘	的牘	的繁体
牚	牚	拒的牚	的繁体
牠	(動物的牠	)的繁体
牣	充牣	的牣	的繁体
牴	牴	觸的牴	的繁体
牷	(牷	供祭祀用純色毛的牛)的繁体
牸	牸	牛的牸	的繁体
牼	(牼	牛膝下的骨頭)的繁体
牽	牽	制的牽	的繁体
犅	(犅	母牛)的繁体
犎	(犎	古代的野牛)的繁体
犖	(犖	雜色的牛)的繁体
犛	犛	牛的犛	的繁体
犢	初生之犢	的犢	的繁体
犣	(犣	旄牛)的繁体
犧	犧	牲的犧	的繁体
犺	(犺	健犬)的繁体
狀	狀	況的狀	的繁体
狉	狉	狉	(野獸成群走動的樣子)的狉	的繁体
狖	狖	猴的狖	的繁体
狥	(狥	同徇私的徇)的繁体
狶	(狶	同豨薟的豨)的繁体
狹	狹	窄的狹	的繁体
狽	狼狽	的狽	的繁体
猂	(猂	同兇悍的悍)的繁体
猇	猇	亭(地名)的猇	的繁体
猋	猋	逝的猋	的繁体
猙	面目猙	獰的猙	的繁体
猨	(猨	同猿猴的猿)的繁体
猰	猰	瘉的猰	的繁体
猲	猲	獢的猲	的繁体
猶	猶	疑的猶	的繁体
猺	猺	目的猺	的繁体
猻	猢猻	的猻	的繁体
獀	(獀	同搜索的搜)的繁体
獃	書獃	子的獃	的繁体
獄	監獄	的獄	的繁体
獅	獅	子的獅	的繁体
獉	獉	狉的獉	的繁体
獋	(獋	同嗥叫的嗥)的繁体
獎	獎	品的獎	的繁体
獢	猲獢	的獢	的繁体
獨	獨	立的獨	的繁体
獪	狡獪	的獪	的繁体
獫	(獫	長喙犬)的繁体
獰	猙獰	的獰	的繁体
獲	獵獲	的獲	的繁体
獵	獵	人的獵	的繁体
獷	粗獷	的獷	的繁体
獸	野獸	的獸	的繁体
獺	水獺	的獺	的繁体
獻	貢獻	的獻	的繁体
獼	獼	猴的獼	的繁体
玀	豬玀	的玀	的繁体
玁	(玁	中國古民族名)的繁体
玅	(玅	同美妙的妙)的繁体
玆	玆	陰補腎的玆	的繁体
玓	玓	瓅(明珠的光)的玓	的繁体
玔	(玔	同銀釧的釧)的繁体
玕	琅玕	的玕	的繁体
玗	玗	琪的玗	的繁体
玠	(玠	大圭)的繁体
玦	玦	玉的玦	的繁体
玨	(玨	兩塊玉合成的玉器)的繁体
珅	(珅	玉名)的繁体
珓	杯珓	的珓	的繁体
珣	(珣	玉名)的繁体
珪	珪	多的珪	的繁体
珮	玉珮	的珮	的繁体
珸	琨珸	的珸	的繁体
珽	(珽	古天子的玉)的繁体
現	現	在的現	的繁体
琀	(琀	古代含於死者口中的珍珠)的繁体
琁	(琁	同璇宮的璇)的繁体
琌	(琌	同丘陵的陵)的繁体
琖	(琖	玉造的酒杯)的繁体
琡	(琡	八寸大的玉器)的繁体
琤	琤	瑽的琤	的繁体
琫	(琫	佩刀飾物)的繁体
琯	(琯	玉管)的繁体
琱	琱	麗的琱	的繁体
琹	(琹	同鋼琴的琴)的繁体
琺	琺	瑯質的琺	的繁体
琿	(琿	美玉)的繁体
瑀	(瑀	像玉的石)的繁体
瑄	(瑄	大壁)的繁体
瑇	(瑇	同玳瑁的玳)的繁体
瑋	瑰瑋	的瑋	的繁体
瑑	(瑑	圭壁上的刻紋)的繁体
瑒	(瑒	玉名)的繁体
瑢	瑽瑢	的瑢	的繁体
瑣	瑣	碎的瑣	的繁体
瑤	瑤	池的瑤	的繁体
瑩	晶瑩	的瑩	的繁体
瑪	瑪	瑙的瑪	的繁体
瑯	琳瑯	滿目的瑯	的繁体
瑱	(瑱	玉器)的繁体
瑲	(瑲	玉聲鈴聲或音樂聲)的繁体
瑳	(瑳	玉色鮮白的樣子)的繁体
瑽	瑽	瑢的瑽	的繁体
璉	箕璉	坊的璉	的繁体
璘	(璘	玉的光彩)的繁体
璟	(璟	玉石的光采)的繁体
璢	(璢	同琉璃的琉)的繁体
璣	珠璣	的璣	的繁体
璦	(璦	美玉)的繁体
環	環	境的環	的繁体
璽	玉璽	的璽	的繁体
璿	(璿	同璇宮的璇)的繁体
瓅	玓瓅	(明珠的光)的瓅	的繁体
瓊	瓊	瑤的瓊	的繁体
瓌	(瓌	同玫瑰的瑰)的繁体
瓏	玲瓏	的瓏	的繁体
瓔	瓔	珞的瓔	的繁体
瓖	(瓖	同鑲嵌的鑲)的繁体
瓚	瓚	玉的瓚	的繁体
瓨	(瓨	同缸瓦的缸)的繁体
瓾	(瓾	同低窪的窪)的繁体
甁	(甁	同花瓶的瓶)的繁体
甃	(甃	用磚塊修井)的繁体
甆	(甆	同瓷器的瓷)的繁体
甌	甌	江的甌	的繁体
甕	甕	缸的甕	的繁体
甖	甖	子口(地名)的甖	的繁体
甞	(甞	同嘗試的嘗)的繁体
產	產	生的產	的繁体
甦	甦	醒的甦	的繁体
甪	甪	里椻的甪	的繁体
甮	(甮	不用之意)的繁体
甴	曱甴	的甴	的繁体
甽	(甽	田間的小水溝)的繁体
甿	(甿	農村居民)的繁体
畂	(畂	同一畝田的畝)的繁体
畆	(畆	同一畝田的畝)的繁体
畇	(畇	田地平坦整齊)的繁体
畝	一畝	田的畝	的繁体
畠	(畠	同甾類化合物的甾)的繁体
畡	(畡	同垓下的垓)的繁体
畢	畢	業的畢	的繁体
畤	(畤	古時帝王祭天的地方)的繁体
畧	(畧	同戰略的略)的繁体
畫	圖畫	的畫	的繁体
畬	畬	族的畬	的繁体
畮	(畮	同一畝田的畝)的繁体
畯	(畯	管理農田的官吏)的繁体
異	異	同的異	的繁体
畱	(畱	同停留的留)的繁体
當	當	然的當	的繁体
畺	(畺	同疆土的疆)的繁体
畼	(畼	同場所的場)的繁体
疇	範疇	的疇	的繁体
疉	(疉	同叠翠豪庭的叠)的繁体
疊	重疊	的疊	的繁体
疍	(疍	同蛋糕的蛋)的繁体
疎	(疎	同疏遠的疏)的繁体
疘	脫疘	的疘	的繁体
疿	(疿	同熱痱的痱)的繁体
痀	痀	僂的痀	的繁体
痁	(痁	瘧疾)的繁体
痌	(痌	同恫嚇的恫)的繁体
痏	(痏	瘡疤)的繁体
痗	(痗	疾病名)的繁体
痙	痙	攣的痙	的繁体
痚	(痚	喉病)的繁体
痠	痠	痛的痠	的繁体
痡	(痡	疲病的意思)的繁体
痯	(痯	抑鬱症)的繁体
痲	痲	疹的痲	的繁体
痳	痳	病的痳	的繁体
痵	(痵	同猶有餘悸的悸)的繁体
痶	(痶	病的模樣)的繁体
痺	麻痺	的痺	的繁体
痾	(痾	疾病)的繁体
瘈	瘈	狗的瘈	的繁体
瘉	病瘉	的瘉	的繁体
瘋	瘋	狂的瘋	的繁体
瘍	潰瘍	的瘍	的繁体
瘏	(瘏	生病)的繁体
瘓	癱瘓	的瘓	的繁体
瘖	瘖	啞(口啞啞)的瘖	的繁体
瘡	瘡	疤的瘡	的繁体
瘧	瘧	疾的瘧	的繁体
療	治療	的療	的繁体
癄	(癄	同憔悴的憔)的繁体
癅	(癅	同腫瘤的瘤)的繁体
癆	肺癆	的癆	的繁体
癇	羊癇	的癇	的繁体
癈	少講癈	話的癈	的繁体
癎	(癎	同羊癇的癇)的繁体
癒	痊癒	的癒	的繁体
癘	瘴癘	的癘	的繁体
癟	癟	三(流氓)的癟	的繁体
癠	(癠	病的意思)的繁体
癡	癡	呆的癡	的繁体
癢	痕癢	的癢	的繁体
癤	鮭魚癤	瘡病的癤	的繁体
癥	病癥	的癥	的繁体
癩	癩	蛤蟆的癩	的繁体
癬	癬	疥的癬	的繁体
癭	(癭	肉瘤)的繁体
癮	癮	君子的癮	的繁体
癰	(癰	膿瘡)的繁体
癱	癱	瘓的癱	的繁体
癲	癲	狂的癲	的繁体
發	發	明的發	的繁体
皁	不分皁	白的皁	的繁体
皃	(皃	同禮貌的貌)的繁体
皐	(皐	同牛皋的皋)(人名)的繁体
皚	皚	皚	白雪的皚	的繁体
皰	水皰	的皰	的繁体
皸	(皸	手足因生凍瘡而破裂)的繁体
皺	皺	紋的皺	的繁体
盃	獎盃	的盃	的繁体
盉	(盉	用來調和酒的器皿)的繁体
盋	(盋	同鉢頭的鉢)的繁体
盌	(盌	同碗碟的碗)的繁体
盜	盜	賊的盜	的繁体
盞	燈盞	的盞	的繁体
盡	盡	責的盡	的繁体
監	監	獄的監	的繁体
盤	盤	算的盤	的繁体
盧	盧	布的盧	的繁体
盩	盩	厔的盩	的繁体
盪	動盪	的盪	的繁体
盳	(盳	同盲人的盲)的繁体
盻	(盻	怒目而視)的繁体
眂	(眂	同視覺的視)的繁体
眊	(眊	眼目昏花)的繁体
眎	(眎	同視覺的視)的繁体
眘	(眘	同謹慎的慎)的繁体
眞	(眞	同真假的真)的繁体
眡	(眡	同視覺的視)的繁体
眥	(眥	眼眶)的繁体
眬	(眬	睡眼朦矓的矓的簡寫)的繁体
眾	眾	多的眾	的繁体
睂	(睂	同眉目的眉)的繁体
睅	(睅	眼睛大而突出)的繁体
睆	(睆	星光明亮的樣子)的繁体
睍	(睍	日出或恐懼)的繁体
睎	(睎	望)的繁体
睏	睏	倦的睏	的繁体
睒	(睒	窺視)的繁体
睖	(睖	瞪着眼睛直看)的繁体
睜	睜	開眼睛的睜	的繁体
睞	青睞	的睞	的繁体
睟	(睟	形容眼光清朗)的繁体
睧	(睧	同昏暗的昏)的繁体
睩	(睩	看的樣子)的繁体
睪	睪	丸的睪	的繁体
瞇	瞇	著眼的瞇	的繁体
瞓	瞓	覺的瞓	的繁体
瞖	(瞖	同心翳的翳)的繁体
瞚	(瞚	同瞬間的瞬)的繁体
瞞	瞞	騙的瞞	的繁体
瞼	眼瞼	的瞼	的繁体
瞾	(瞾	同照顧的照)的繁体
矁	(矁	同瞅着的瞅)的繁体
矇	矇	騙的矇	的繁体
矉	(矉	悵恨而張眼)的繁体
矓	睡眼朦矓	的矓	的繁体
矙	(矙	同俯瞰的瞰)的繁体
矚	矚	目的矚	的繁体
矦	矦	蟧的矦	的繁体
矯	矯	正的矯	的繁体
矱	(矱	尺度或標準)的繁体
矴	(矴	同石碇的碇)的繁体
矺	(矺	同磔刑的磔)的繁体
矻	矻	矻	(努力勤奮的樣子)的矻	的繁体
砆	碔砆	(像玉的石頭)的砆	的繁体
砏	砏	汃的砏	的繁体
砠	山砠	的砠	的繁体
砢	砢	磣的砢	的繁体
砫	石砫	(縣名)的砫	的繁体
砲	(砲	通槍炮的炮)的繁体
砵	砵	頭(常用)的砵	的繁体
硃	硃	砂的硃	的繁体
硋	(硋	同障礙的礙)的繁体
硏	(硏	同研究的研)的繁体
硜	(硜	石頭相擊)的繁体
硠	(硠	玉石相擊聲)的繁体
硤	(硤	兩山間的溪谷)的繁体
硨	硨	磲貝的硨	的繁体
硯	墨硯	的硯	的繁体
硵	(硵	磠碼的磠的簡寫)的繁体
硶	(硶	同砢磣的磣)的繁体
碁	宏碁	的碁	的繁体
碏	(碏	殘破的碑)的繁体
碕	(碕	曲折的堤岸)的繁体
碨	(碨	石磨)的繁体
碩	碩	果的碩	的繁体
碪	(碪	同砧板的砧)的繁体
碭	碭	山的碭	的繁体
碯	(碯	同瑪瑙的瑙)的繁体
確	確	定的確	的繁体
碼	號碼	的碼	的繁体
磎	(磎	同溪澗的溪)的繁体
磒	(磒	同隕石的隕)的繁体
磖	(磖	同砬子的砬)(大石塊)的繁体
磚	磚	塊的磚	的繁体
磠	磠	碼的磠	的繁体
磡	紅磡	的磡	的繁体
磣	砢磣	的磣	的繁体
磧	磧	礫的磧	的繁体
磯	洛磯	山的磯	的繁体
礆	(礆	同危險的險)的繁体
礎	基礎	的礎	的繁体
礙	障礙	的礙	的繁体
礡	磅礡	的礡	的繁体
礦	礦	產的礦	的繁体
礪	磨礪	的礪	的繁体
礫	瓦礫	的礫	的繁体
礬	明礬	的礬	的繁体
礮	(礮	同槍炮的炮)的繁体
祂	(神的祂	)的繁体
祅	祅	教(拜火教)的祅	的繁体
祏	(祏	藏神主的石盒)的繁体
祐	庇祐	的祐	的繁体
祕	(祕	同秘密的秘)的繁体
祲	祲	兆的祲	的繁体
祵	(祵	同捆綁的捆)的繁体
祼	(祼	祭祀儀式)的繁体
祿	福祿	的祿	的繁体
禇	(禇	同褚遂良的褚)的繁体
禍	禍	害的禍	的繁体
禎	崇禎	(人名)的禎	的繁体
禘	(禘	古代一種祭祀)的繁体
禥	(禥	同安祺的祺)的繁体
禦	防禦	的禦	的繁体
禩	(禩	同祭祀的祀)的繁体
禪	禪	師的禪	的繁体
禮	禮	貌的禮	的繁体
禰	禰	衡的禰	的繁体
禱	禱	告的禱	的繁体
禿	禿	頭的禿	的繁体
秊	(秊	同年齡的年)的繁体
秏	秏	電量的秏	的繁体
秔	(秔	同粳稻的粳)(植物名)的繁体
秬	(秬	黑黍)的繁体
秾	(秾	穠纖適宜的穠的簡寫)的繁体
稅	稅	務的稅	的繁体
稈	禾稈	草的稈	的繁体
稉	(稉	同粳稻的粳)(植物名)的繁体
稊	稊	米的稊	的繁体
稌	(稌	即稻米)的繁体
稙	稙	宗的稙	的繁体
稜	稜	鏡的稜	的繁体
稟	稟	告的稟	的繁体
稤	(稤	同侵掠的掠)的繁体
稬	(稬	同糯米的糯)的繁体
稭	(稭	同豆秸的秸)的繁体
種	種	類的種	的繁体
稱	稱	呼的稱	的繁体
稺	(稺	同幼稚的稚)的繁体
稾	(稾	同文稿的稿)的繁体
穀	穀	物的穀	的繁体
穅	(穅	同木糠的糠)的繁体
穇	穇	子(植物名)的穇	的繁体
穌	耶穌	的穌	的繁体
積	積	極的積	的繁体
穎	聰穎	的穎	的繁体
穠	穠	纖適宜的穠	的繁体
穡	稼穡	的穡	的繁体
穢	污穢	的穢	的繁体
穤	(穤	同糯米的糯)的繁体
穧	(穧	已割下而未紮束的稻)的繁体
穨	穨	唐(墜落的樣子)的穨	的繁体
穩	穩	健的穩	的繁体
穫	收穫	的穫	的繁体
穭	(穭	野生的稻)的繁体
穵	穵	井的穵	的繁体
窌	(窌	針灸穴位名)的繁体
窐	(窐	同低窪的窪)的繁体
窓	(窓	同窗戶的窗)的繁体
窛	(窛	同賊寇的寇)的繁体
窩	窩	藏的窩	的繁体
窪	低窪	的窪	的繁体
窮	窮	人的窮	的繁体
窯	窯	洞的窯	的繁体
窺	偷窺	的窺	的繁体
竄	竄	改的竄	的繁体
竅	竅	門的竅	的繁体
竇	鼻竇	炎的竇	的繁体
竊	偷竊	的竊	的繁体
竢	(竢	同俟機的俟)(等待)的繁体
竵	(竵	同歪曲的歪)的繁体
競	競	爭的競	的繁体
竻	(竻	竹根)的繁体
笇	(笇	同計算的算)的繁体
笭	笭	箐的笭	的繁体
笻	扶笻	的笻	的繁体
筆	筆	記的筆	的繁体
筊	杯筊	的筊	的繁体
筍	竹筍	的筍	的繁体
筜	(筜	篔簹的簹的簡寫)(大竹名)的繁体
筞	(筞	同策劃的策)的繁体
筥	(筥	盛物的圓竹器)的繁体
筧	筧	橋的筧	的繁体
筩	(筩	竹筒)的繁体
筭	(筭	計算曆數的器具)的繁体
筰	(筰	古代民族名)的繁体
筴	(筴	計策)的繁体
筼	(筼	篔簹的篔的簡寫)(大竹名)的繁体
筿	(筿	筱華的筱的簡寫)的繁体
箄	(箄	大筏)的繁体
箇	箇	中的箇	的繁体
箋	信箋	的箋	的繁体
箌	(箌	捕魚的器具)的繁体
箏	風箏	的箏	的繁体
箘	白箘	湯的箘	的繁体
箣	(箣	同策劃的策)的繁体
箲	(箲	同筅帚的筅)的繁体
節	節	日的節	的繁体
範	範	圍的範	的繁体
築	建築	的築	的繁体
篔	篔	簹(大竹名)的篔	的繁体
篛	筍篛	的篛	的繁体
篠	(篠	小竹)的繁体
篤	篤	信的篤	的繁体
篨	籧篨	(病名)的篨	的繁体
篩	篩	選的篩	的繁体
篯	(篯	籛鏗的籛的簡寫)的繁体
篳	篳	路藍縷的篳	的繁体
簂	(簂	同巾幗的幗)的繁体
簆	(簆	同鋼筘的筘)的繁体
簍	竹簍	的簍	的繁体
簑	(簑	同蓑衣的蓑)的繁体
簒	(簒	同篡奪的篡)的繁体
簔	(簔	同蓑衣的蓑)的繁体
簕	簕	杜鵑的簕	的繁体
簞	簞	薄的簞	的繁体
簡	簡	單的簡	的繁体
簣	功虧一簣	的簣	的繁体
簫	洞簫	的簫	的繁体
簮	(簮	同玉簪的簪)的繁体
簳	(簳	做箭的小竹)的繁体
簷	簷	篷的簷	的繁体
簹	篔簹	(大竹名)的簹	的繁体
簻	(簻	馬鞭)的繁体
簽	簽	名的簽	的繁体
簾	窗簾	的簾	的繁体
籃	籃	球的籃	的繁体
籌	籌	款的籌	的繁体
籐	籐	器的籐	的繁体
籑	(籑	同饌珍的饌)的繁体
籕	(籕	同籀文的籀)的繁体
籛	籛	鏗的籛	的繁体
籜	(籜	竹皮或筍殼)的繁体
籟	天籟	的籟	的繁体
籠	鳥籠	的籠	的繁体
籢	(籢	同陪奩的奩)的繁体
籤	標籤	的籤	的繁体
籥	(籥	古代樂器)的繁体
籧	籧	篨(病名)的籧	的繁体
籨	(籨	同陪奩的奩)的繁体
籩	籩	頭(祭祀的禮器)的籩	的繁体
籪	(籪	捕魚蝦的竹欄)的繁体
籬	籬	笆的籬	的繁体
籮	竹籮	的籮	的繁体
籯	(籯	一種竹製的盛物筐籠)的繁体
籲	呼籲	的籲	的繁体
粄	粄	條的粄	的繁体
粇	(粇	同木糠的糠)的繁体
粦	(粦	同磷酸的磷)的繁体
粧	化粧	的粧	的繁体
粰	(粰	同麥麩的麩)的繁体
粵	(粵	廣東的簡稱)的繁体
糂	(糂	同糝食的糝)的繁体
糉	鹹肉糉	的糉	的繁体
糚	(糚	同梳妝的妝)的繁体
糝	(糝	飯粒)的繁体
糞	糞	便的糞	的繁体
糡	(糡	同糨糊的糨)的繁体
糢	(糢	通模糊的模)的繁体
糧	糧	食的糧	的繁体
糪	(糪	半生半熟的飯)的繁体
糰	飯糰	的糰	的繁体
糲	(糲	粗米)的繁体
糴	糴	米的糴	的繁体
糷	糷	諡的糷	的繁体
糺	(糺	同糾紛的糾)的繁体
糾	糾	紛的糾	的繁体
糿	(糿	同年幼的幼)的繁体
紀	紀	律的紀	的繁体
紂	紂	王的紂	的繁体
約	約	會的約	的繁体
紅	紅	色的紅	的繁体
紆	紆	子于歸的紆	的繁体
紈	紈	褲子弟的紈	的繁体
紉	縫紉	的紉	的繁体
紋	花紋	的紋	的繁体
納	納	稅的納	的繁体
紐	紐	約的紐	的繁体
紓	紓	尊降貴的紓	的繁体
純	純	正的純	的繁体
紕	紕	漏的紕	的繁体
紖	(紖	牽牲口的繩子)的繁体
紗	紗	布的紗	的繁体
紘	(紘	古代禮帽上的繫帶)的繁体
紙	報紙	的紙	的繁体
級	級	別的級	的繁体
紛	紛	爭的紛	的繁体
紜	眾說紛紜	的紜	的繁体
紝	(紝	織布帛的絲縷)的繁体
紡	紡	織的紡	的繁体
紮	紮	營的紮	的繁体
細	細	心的細	的繁体
紱	印紱	的紱	的繁体
紲	(紲	繩索)的繁体
紳	紳	士的紳	的繁体
紹	介紹	的紹	的繁体
紺	(紺	微帶紅的黑色)的繁体
紼	執紼	的紼	的繁体
絀	短絀	的絀	的繁体
終	終	結的終	的繁体
絃	斷絃	的絃	的繁体
組	組	織的組	的繁体
絆	絆	腳的絆	的繁体
絏	嫘絏	的絏	的繁体
結	結	果的結	的繁体
絓	(絓	同懸掛的掛)的繁体
絕	絕	對的絕	的繁体
絖	(絖	一綑細繩)的繁体
絛	絛	蟲的絛	的繁体
絞	絞	刑的絞	的繁体
絡	聯絡	的絡	的繁体
絢	絢	爛的絢	的繁体
給	給	予的給	的繁体
絨	絨	毛的絨	的繁体
絪	絪	縕的絪	的繁体
絰	(絰	麻葛做的悼服)的繁体
統	統	計的統	的繁体
絲	絲	綢的絲	的繁体
絳	絳	牛的絳	的繁体
絸	(絸	同蠶繭的繭)的繁体
絹	(絹	絲織品)的繁体
絺	(絺	細的葛布)的繁体
絻	(絻	喪服)的繁体
絿	(絿	急迫的樣子)的繁体
綁	捆綁	的綁	的繁体
綂	(綂	同統計的統)的繁体
綃	(綃	生絲織物)的繁体
綆	綆	短汲深的綆	的繁体
綈	綈	袍的綈	的繁体
綉	(綉	錦繡的繡的香港寫法)的繁体
綌	(綌	粗的葛布)的繁体
綍	(綍	大繩)的繁体
綏	綏	遠的綏	的繁体
綑	一綑	的綑	的繁体
經	經	驗的經	的繁体
綜	綜	合的綜	的繁体
綞	(綞	再加)的繁体
綠	綠	色的綠	的繁体
綢	綢	緞的綢	的繁体
綣	繾綣	的綣	的繁体
綧	(綧	同準備的準)的繁体
綫	(綫	線索的線的香港寫法)的繁体
綬	綬	帶的綬	的繁体
維	維	持的維	的繁体
綰	綰	髻的綰	的繁体
綱	綱	領的綱	的繁体
網	網	羅的網	的繁体
綴	點綴	的綴	的繁体
綵	剪綵	的綵	的繁体
綷	綷	菜的綷	的繁体
綸	(綸	青絲)的繁体
綹	(綹	成束的絲線)的繁体
綺	綺	夢的綺	的繁体
綻	破綻	的綻	的繁体
綽	綽	頭的綽	的繁体
綾	綾	羅綢緞的綾	的繁体
綿	綿	羊的綿	的繁体
緄	(緄	繩)的繁体
緅	(緅	青赤色)的繁体
緇	緇	衣的緇	的繁体
緊	緊	張的緊	的繁体
緋	緋	聞的緋	的繁体
緐	(緐	同繁榮的繁)的繁体
緒	頭緒	的緒	的繁体
緖	(緖	同頭緒的緒)的繁体
緘	緘	默的緘	的繁体
線	線	索的線	的繁体
緝	緝	私的緝	的繁体
緞	綢緞	的緞	的繁体
締	締	造的締	的繁体
緣	緣	份的緣	的繁体
編	編	輯的編	的繁体
緩	緩	慢的緩	的繁体
緫	(緫	同總結的總)的繁体
緬	緬	甸的緬	的繁体
緯	經緯	的緯	的繁体
緲	飄緲	的緲	的繁体
練	練	習的練	的繁体
緹	緹	縈的緹	的繁体
緻	細緻	的緻	的繁体
縂	(縂	同總結的總)的繁体
縈	縈	繞的縈	的繁体
縉	縉	皇居的縉	的繁体
縊	自縊	的縊	的繁体
縋	縋	下(綁着繩子放下去)的縋	的繁体
縐	縐	布的縐	的繁体
縑	(縑	雙絲的細絹)的繁体
縛	束縛	的縛	的繁体
縝	縝	密的縝	的繁体
縞	縞	衣的縞	的繁体
縟	繁文縟	節的縟	的繁体
縣	郡縣	的縣	的繁体
縫	縫	紉的縫	的繁体
縮	縮	小的縮	的繁体
縱	縱	容的縱	的繁体
縲	(縲	捆綁犯人的繩)的繁体
縴	(縴	拉船前進)的繁体
縵	(縵	沒有文彩的素綢)的繁体
縷	縷	縷	炊煙的縷	的繁体
縹	縹	緲的縹	的繁体
總	總	結的總	的繁体
績	成績	的績	的繁体
繃	繃	帶的繃	的繁体
繅	繅	絲的繅	的繁体
繆	未雨綢繆	的繆	的繁体
繈	(繈	襁保之意)的繁体
繒	(繒	絲織品的總稱)的繁体
織	紡織	的織	的繁体
繕	繕	寫的繕	的繁体
繙	(繙	同翻譯的翻)的繁体
繚	繚	繞的繚	的繁体
繞	繞	圈的繞	的繁体
繡	錦繡	的繡	的繁体
繦	(繦	同襁褓的襁)的繁体
繨	紇繨	(繩結)的繨	的繁体
繩	繩	索的繩	的繁体
繪	繪	畫的繪	的繁体
繫	維繫	的繫	的繁体
繭	蠶繭	的繭	的繁体
繮	馬繮	的繮	的繁体
繯	繯	首(絞刑)的繯	的繁体
繲	(繲	洗衣)的繁体
繳	繳	費的繳	的繁体
繵	(繵	纏繞)的繁体
繶	(繶	絲織的帶子)的繁体
繸	(繸	用來繫瑞玉的絲蔕)的繁体
繹	演繹	的繹	的繁体
繼	繼	續的繼	的繁体
繽	繽	紛的繽	的繁体
繾	繾	綣的繾	的繁体
纈	(纈	眼花時見的星星點點)的繁体
纊	纊	衣(絲綿衣)的纊	的繁体
續	繼續	的續	的繁体
纍	傷痕纍	纍	的纍	的繁体
纏	纏	綿的纏	的繁体
纓	纓	帽的纓	的繁体
纔	方纔	的纔	的繁体
纖	纖	維的纖	的繁体
纘	纘	續(繼承)的纘	的繁体
纜	纜	車的纜	的繁体
缐	(缐	線索的線的簡寫)的繁体
缽	(缽	同鉢頭的鉢)的繁体
缾	(缾	瓶)的繁体
罆	(罆	同罐頭的罐)的繁体
罈	酒罈	的罈	的繁体
罋	(罋	瓦器)的繁体
罌	罌	粟的罌	的繁体
罍	金罍	美酒的罍	的繁体
罙	(罙	同深淺的深)的繁体
罣	罣	礙的罣	的繁体
罥	(罥	掛礙)的繁体
罫	(罫	方格子)的繁体
罬	(罬	古代的捕鳥網具)的繁体
罭	(罭	捕魚的網)的繁体
罰	處罰	的罰	的繁体
罵	責罵	的罵	的繁体
罷	罷	工的罷	的繁体
罸	(罸	同處罰的罰)的繁体
羅	羅	列的羅	的繁体
羆	熊羆	(動物名)的羆	的繁体
羈	羈	留的羈	的繁体
羋	(羋	羊叫聲)的繁体
羖	(羖	黑色的羚羊)的繁体
羣	(羣	同群眾的群)的繁体
羥	羥	基的羥	的繁体
羨	艷羨	的羨	的繁体
義	義	氣的義	的繁体
羴	(羴	同膻中穴的膻)的繁体
羶	(羶	羊的騷臭)的繁体
羷	(羷	羊的一種)的繁体
翀	(翀	向上直飛)的繁体
翄	(翄	同翅膀的翅)的繁体
翍	(翍	同披肩的披)的繁体
習	習	慣的習	的繁体
翙	(翙	翽翽的翽的簡寫)(形容鳥飛的聲音)的繁体
翛	(翛	快捷)的繁体
翫	翫	歲愒時的翫	的繁体
翹	銀翹	的翹	的繁体
翽	翽	翽	(形容鳥飛的聲音)的翽	的繁体
翾	翾	風(輕輕地飛)的翾	的繁体
耑	(耑	同專業的專)的繁体
耡	(耡	同鋤頭的鋤)的繁体
聀	(聀	同職業的職)的繁体
聓	(聓	同女婿的婿)的繁体
聖	聖	人的聖	的繁体
聝	(聝	割去俘擄耳朶的刑法)的繁体
聞	新聞	的聞	的繁体
聦	(聦	同聰明的聰)的繁体
聯	聯	合的聯	的繁体
聰	聰	明的聰	的繁体
聲	聲	音的聲	的繁体
聳	高聳	的聳	的繁体
聵	(聵	天生耳聾)的繁体
聶	(姓氏聶	)的繁体
職	職	業的職	的繁体
聹	耵聹	(耳垢)的聹	的繁体
聽	聽	眾的聽	的繁体
聾	聾	啞的聾	的繁体
肅	肅	靜的肅	的繁体
肈	(肈	同肇事的肇)的繁体
肎	(肎	同肯定的肯)的繁体
肏	肏	性交的繁体
肧	(肧	同胚胎的胚)的繁体
肨	(肨	同肥胖的胖)的繁体
肬	(肬	同附贅懸疣的疣)的繁体
胈	(胈	大腿上的小毛)的繁体
胉	(胉	同肩膊的膊)的繁体
胊	胊	縣(山東省)的胊	的繁体
胏	噬乾胏	的胏	的繁体
胐	(胐	睥藏附近之孔竅)的繁体
胑	(胑	同肢體的肢)的繁体
胔	(胔	腐肉)的繁体
胕	(胕	同皮膚的膚)的繁体
胠	(胠	身體腋下)的繁体
胣	(胣	古代邢法)的繁体
胮	(胮	同肩膀的膀)的繁体
胷	(胷	同胸襟的胸)的繁体
胾	(胾	切肉)的繁体
脃	(脃	同脆弱的脆)的繁体
脅	威脅	的脅	的繁体
脈	脈	搏的脈	的繁体
脗	(脗	同接吻的吻)的繁体
脛	脛	骨的脛	的繁体
脣	反脣	相譏的脣	的繁体
脩	束脩	的脩	的繁体
脫	脫	離的脫	的繁体
脷	豬脷	的脷	的繁体
脹	膨脹	的脹	的繁体
腁	(腁	同胼手胝足的胼)的繁体
腎	腎	臟的腎	的繁体
腒	(腒	鳥類的乾肉)的繁体
腡	(腡	手指紋)的繁体
腤	腤	臃的腤	的繁体
腦	腦	袋的腦	的繁体
腫	腫	瘤的腫	的繁体
腯	(腯	肥胖)的繁体
腳	手腳	的腳	的繁体
腶	腶	脩的腶	的繁体
腷	腷	臆(同愊憶)的腷	的繁体
腸	腸	胃的腸	的繁体
膃	(膃	肥胖)的繁体
膆	(膆	同嗉囊的嗉)的繁体
膇	(膇	腳腫)的繁体
膌	(膌	同貧瘠的瘠)的繁体
膓	(膓	同腸胃的腸)的繁体
膚	皮膚	的膚	的繁体
膠	橡膠	的膠	的繁体
膩	油膩	的膩	的繁体
膽	膽	量的膽	的繁体
膾	膾	炙人口的膾	的繁体
膿	膿	瘡的膿	的繁体
臈	(臈	同臘肉的臘)的繁体
臉	臉	龐的臉	的繁体
臋	(臋	同臀部的臀)的繁体
臍	肚臍	的臍	的繁体
臏	臏	骨的臏	的繁体
臕	上臕	的臕	的繁体
臗	(臗	同髖骨的髖)的繁体
臘	臘	肉的臘	的繁体
臚	臚	列的臚	的繁体
臜	(臜	腌臢的臢的簡寫)的繁体
臞	(臞	瘦的樣子)的繁体
臟	心臟	的臟	的繁体
臠	臠	肉(切成小塊的肉)的臠	的繁体
臢	腌臢	的臢	的繁体
臥	臥	室的臥	的繁体
臨	臨	時的臨	的繁体
臮	(臮	同暨所屬的暨)的繁体
臯	(臯	同牛皋的皋)(人名)的繁体
臺	(臺	台灣的台正寫)的繁体
與	我與	你的與	的繁体
興	興	奮的興	的繁体
舉	舉	行的舉	的繁体
舊	新舊	的舊	的繁体
舋	(舋	挑釁的釁的簡寫)的繁体
舖	舖	頭的舖	的繁体
舦	舦	房的舦	的繁体
舺	艋舺	的舺	的繁体
艅	艅	艎的艅	的繁体
艎	艅艎	的艎	的繁体
艙	船艙	的艙	的繁体
艡	艡	伢的艡	的繁体
艢	(艢	同檣帆的檣)的繁体
艣	(艣	一種比槳大的划船工具)的繁体
艤	艤	船(使船靠岸)的艤	的繁体
艦	艦	艇的艦	的繁体
艪	(艪	同搖櫓的櫓)的繁体
艫	舳艫	千里的艫	的繁体
艱	艱	難的艱	的繁体
艶	(艶	同艷麗的艷)的繁体
艷	艷	麗的艷	的繁体
艸	艸	野的艸	的繁体
芃	芃	芃	(草木茂密)的芃	的繁体
芅	(芅	木質籐本)的繁体
芣	(芣	植物名-即車前子)的繁体
芲	(芲	同花朵的花)的繁体
芵	芵	陌的芵	的繁体
芻	反芻	的芻	的繁体
苅	(苅	同刈稻的刈)的繁体
苙	(苙	豬欄)的繁体
苧	苧	麻(植物名)的苧	的繁体
苺	(苺	同草莓的莓)的繁体
苽	(苽	同菰蒲的菰)的繁体
苾	(苾	噴香)的繁体
茀	茀	羅的茀	的繁体
茍	茍	同的茍	的繁体
茢	(茢	荊棘)的繁体
茲	茲	收到的茲	的繁体
荄	(荄	草根)的繁体
荈	(荈	晚採的茶)的繁体
荊	荊	棘的荊	的繁体
荍	(荍	植物一種)的繁体
荎	荎	藸(五味子)的荎	的繁体
荝	(荝	萴子的萴的簡寫)的繁体
荳	荳	蔻的荳	的繁体
莊	莊	嚴的莊	的繁体
莕	莕	菜的莕	的繁体
莖	根莖	的莖	的繁体
莝	莝	草的莝	的繁体
莢	豆莢	的莢	的繁体
莧	莧	菜的莧	的繁体
莿	莿	桐的莿	的繁体
菂	(菂	蓮子)的繁体
菉	(菉	草名)的繁体
菑	(菑	耕種一年的田土)的繁体
菢	(菢	鳥類孵卵)的繁体
華	華	人的華	的繁体
菴	菴	藹的菴	的繁体
菷	(菷	同掃帚的帚)的繁体
菼	(菼	青白雙間的顏色)的繁体
菾	(菾	蔬類植物)的繁体
萅	(萅	同春天的春)的繁体
萇	萇	楚的萇	的繁体
萊	蓬萊	的萊	的繁体
萖	(萖	同莞爾的莞)的繁体
萗	(萗	同策劃的策)的繁体
萣	茄萣	的萣	的繁体
萩	萩	城的萩	的繁体
萬	千萬	的萬	的繁体
萲	(萲	同萱草的萱)的繁体
萴	萴	子的萴	的繁体
萵	萵	苣(菠菜)的萵	的繁体
葉	樹葉	的葉	的繁体
葌	(葌	同草菅人命的菅)的繁体
葍	(葍	葉大的白花)的繁体
葎	(葎	植物名)的繁体
葒	葒	菜的葒	的繁体
葖	(葖	植物名即蘿蔔)的繁体
葠	(葠	同人參的參)的繁体
葥	(葥	草名)的繁体
葦	蘆葦	的葦	的繁体
葧	(葧	白蒿或花蕊)的繁体
葯	西葯	的葯	的繁体
葴	(葴	草名)的繁体
葷	食葷	的葷	的繁体
葹	(葹	植物名)的繁体
葽	葽	繞的葽	的繁体
蒍	(蒍	草名)的繁体
蒐	蒐	集的蒐	的繁体
蒔	蒔	弄的蒔	的繁体
蒞	蒞	臨的蒞	的繁体
蒟	蒟	蒻的蒟	的繁体
蒨	蒨	草的蒨	的繁体
蒭	(蒭	同反芻的芻)的繁体
蒻	蒟蒻	的蒻	的繁体
蒼	蒼	老的蒼	的繁体
蓀	(蓀	蒿類植物)的繁体
蓂	蓂	莢的蓂	的繁体
蓆	竹蓆	的蓆	的繁体
蓇	蓇	葖的蓇	的繁体
蓋	蓋	章的蓋	的繁体
蓏	(蓏	瓜類植物的果實)的繁体
蓡	(蓡	同參與的參)的繁体
蓮	蓮	花的蓮	的繁体
蓱	(蓱	同湟潦生苹的苹)的繁体
蓷	(蓷	植物名)的繁体
蓽	蓽	撥(植物名)的蓽	的繁体
蔆	(蔆	同菱角之菱)的繁体
蔇	(蔇	地名)的繁体
蔐	(蔐	同荻花的荻)的繁体
蔔	蘿蔔	的蔔	的繁体
蔘	人蔘	的蔘	的繁体
蔞	蔞	蒿的蔞	的繁体
蔣	(姓氏蔣	)的繁体
蔥	(蔥	葱蒜的葱的本字)的繁体
蔦	蔦	松的蔦	的繁体
蔭	蔭	庇的蔭	的繁体
蔴	油蔴	地的蔴	的繁体
蕁	蕁	麻(植物)的蕁	的繁体
蕅	(蕅	同蓮藕的藕)的繁体
蕎	蕎	麥的蕎	的繁体
蕏	(蕏	同荎藸的藸)(五味子)的繁体
蕩	蕩	漾的蕩	的繁体
蕪	荒蕪	的蕪	的繁体
蕭	蕭	條的蕭	的繁体
蕯	(蕯	同菩薩的薩)的繁体
蕿	(蕿	同萱草的萱)的繁体
薀	薀	莎公爵的薀	的繁体
薈	蘆薈	的薈	的繁体
薊	薊	縣的薊	的繁体
薑	薑	醋的薑	的繁体
薔	薔	薇花的薔	的繁体
薙	(薙	通剃刀的剃)的繁体
薦	毛遂自薦	的薦	的繁体
薩	菩薩	的薩	的繁体
薳	(薳	草名)的繁体
薺	荸薺	(馬蹄)的薺	的繁体
藍	藍	色的藍	的繁体
藑	藑	茅(草名)的藑	的繁体
藘	茹藘	(草名)的藘	的繁体
藚	(藚	植物名)的繁体
藝	藝	術的藝	的繁体
藟	縈藟	的藟	的繁体
藥	藥	材的藥	的繁体
藪	(藪	湖澤)的繁体
藫	(藫	海藻的一種)的繁体
藭	芎藭	(川芎)的藭	的繁体
藳	(藳	同文稿的稿)的繁体
藶	葶藶	的藶	的繁体
藷	(藷	同薯仔的薯)的繁体
藸	荎藸	(五味子)的藸	的繁体
藹	和藹	的藹	的繁体
藺	(姓氏藺	)的繁体
藼	(藼	同萱草的萱)的繁体
蘀	(蘀	草木脫落的皮或葉)的繁体
蘄	(蘄	香草)的繁体
蘆	葫蘆	的蘆	的繁体
蘇	復蘇	的蘇	的繁体
蘊	蘊	藏的蘊	的繁体
蘋	蘋	果的蘋	的繁体
蘐	(蘐	同萱草的萱)的繁体
蘓	(蘓	同復蘇的蘇)的繁体
蘗	蘗	木的蘗	的繁体
蘚	苔蘚	的蘚	的繁体
蘜	(蘜	同菊花的菊)的繁体
蘢	蘢	葱(形容草木翠綠茂盛)的蘢	的繁体
蘤	蘤	嘔的蘤	的繁体
蘭	蘭	花的蘭	的繁体
蘿	蘿	蔔的蘿	的繁体
處	處	境的處	的繁体
虛	虛	實的虛	的繁体
虜	俘虜	的虜	的繁体
號	號	召的號	的繁体
虧	虧	空的虧	的繁体
虯	虯	髯的虯	的繁体
虵	(虵	同蛇王的蛇)的繁体
蚖	(蚖	同蠑螈的螈)的繁体
蚘	(蚘	同蛔蟲的蛔)的繁体
蛕	(蛕	同蛔蟲的蛔)的繁体
蛺	蛺	蝶的蛺	的繁体
蛻	蛻	變的蛻	的繁体
蜆	蜆	殼的蜆	的繁体
蜋	螳蜋	的蜋	的繁体
蜑	蜑	族的蜑	的繁体
蜖	(蜖	同蛔蟲的蛔)的繁体
蜯	(蜯	同蚌殼的蚌)的繁体
蜰	(蜰	臭蟲)的繁体
蜹	(蜹	同蚊蚋的蚋)的繁体
蜽	(蜽	同魍魎的魎)的繁体
蝀	蝃蝀	的蝀	的繁体
蝃	蝃	蝀的蝃	的繁体
蝄	(蝄	同魍魎的魍)的繁体
蝍	蝍	蛆的蝍	的繁体
蝕	腐蝕	的蝕	的繁体
蝟	刺蝟	的蝟	的繁体
蝦	蝦	蟹的蝦	的繁体
蝨	(蝨	跳虱的虱的正體字)的繁体
蝪	蜥蝪	的蝪	的繁体
蝯	(蝯	同猿人的猿)的繁体
蝳	(蝳	同玳瑁的玳)的繁体
蝸	蝸	牛的蝸	的繁体
螄	螺螄	(蟲名)的螄	的繁体
螎	(螎	同融洽的融)的繁体
螙	(螙	同蠹魚的蠹)的繁体
螞	螞	蟻的螞	的繁体
螡	(螡	同蚊蟲的蚊)的繁体
螢	螢	火蟲的螢	的繁体
螻	蛄螻	的螻	的繁体
蟁	(蟁	同蚊蟲的蚊)的繁体
蟄	蟄	伏的蟄	的繁体
蟇	(蟇	同蛤蟆的蟆)的繁体
蟈	蟈	蟈	兒(昆蟲名)的蟈	的繁体
蟎	蟲蟎	的蟎	的繁体
蟏	(蟏	蠨蛸的蠨的簡寫)(蟲名)的繁体
蟧	矦蟧	的蟧	的繁体
蟬	(蟬	昆蟲名)的繁体
蟯	蟯	蟲的蟯	的繁体
蟲	昆蟲	的蟲	的繁体
蟶	蟶	子(軟體動物)的蟶	的繁体
蟷	蟷	螂(蟲名)的蟷	的繁体
蟺	蛐蟺	(蚯蚓)的蟺	的繁体
蟻	螞蟻	的蟻	的繁体
蠄	蠄	蟧的蠄	的繁体
蠅	蒼蠅	的蠅	的繁体
蠆	(蠆	毒蟲)的繁体
蠉	(蠉	蟲名)的繁体
蠋	蠋	蝓(蛾或蝶一類的昆蟲)的蠋	的繁体
蠌	螖蠌	(寄居蟲)的蠌	的繁体
蠍	蛇蠍	的蠍	的繁体
蠐	蠐	螬(蟲名)的蠐	的繁体
蠑	蠑	螈的蠑	的繁体
蠒	(蠒	同蠶繭的繭)的繁体
蠔	蠔	油的蠔	的繁体
蠜	(蠜	昆蟲名)的繁体
蠟	蠟	燭的蠟	的繁体
蠣	牡蠣	的蠣	的繁体
蠧	(蠧	同蠹魚的蠹)的繁体
蠨	蠨	蛸(蟲名)的蠨	的繁体
蠱	蠱	惑的蠱	的繁体
蠵	蠵	龜科動物的蠵	的繁体
蠶	蠶	食的蠶	的繁体
蠻	橫蠻	的蠻	的繁体
衃	(衃	凝積的死血)的繁体
衇	(衇	同脉衝的脉)的繁体
衊	污衊	的衊	的繁体
衒	(衒	自誇的意思)的繁体
術	美術	的術	的繁体
衘	(衘	同銜頭的銜)的繁体
衛	保衛	的衛	的繁体
衜	(衜	同道路的道)的繁体
衝	衝	鋒的衝	的繁体
衞	(衞	衛生的衛的香港寫法)的繁体
衭	(衭	衣服的前襟)的繁体
衵	(衵	貼身衣)的繁体
衹	(衹	通只是的只)的繁体
衺	(衺	同邪門的邪)的繁体
袆	(袆	褘衣的褘的簡寫)的繁体
袌	(袌	同擁抱的抱)的繁体
袛	(袛	恭敬)的繁体
袞	袞	拯的袞	的繁体
袟	(袟	同卷帙浩繁的帙)的繁体
袠	(袠	同卷帙浩繁的帙)的繁体
袪	袪	風去濕的袪	的繁体
裀	裀	褥的裀	的繁体
裊	餘音裊	裊	的裊	的繁体
裌	(裌	同嘴巴的嘴)的繁体
裏	(裏	裡面的裡的香港寫法)的繁体
裛	(裛	纏繞)的繁体
補	補	充的補	的繁体
裝	裝	置的裝	的繁体
裠	(裠	同裙子的裙)的繁体
裡	裡	面的裡	的繁体
製	製	造的製	的繁体
複	複	製的複	的繁体
褏	(褏	同衣袖的袖)的繁体
褕	襜褕	的褕	的繁体
褘	(褘	蔽膝)的繁体
褟	汗褟	的褟	的繁体
褭	騕褭	(古代駿馬名)的褭	的繁体
褲	衫褲	的褲	的繁体
褸	襤褸	的褸	的繁体
褻	淫褻	的褻	的繁体
褽	(褽	墊於下面)的繁体
襃	(襃	同褒獎的褒)的繁体
襍	(襍	同複雜的雜)的繁体
襖	棉襖	的襖	的繁体
襚	(襚	送給死人穿的衣服)的繁体
襛	襛	華(衣服很厚的樣子)的襛	的繁体
襜	(襜	衣服的底擺)的繁体
襝	襝	衽(古時女子的拜手行禮)的襝	的繁体
襠	褲襠	的襠	的繁体
襢	(襢	同袒白的袒)的繁体
襤	襤	褸的襤	的繁体
襪	鞋襪	的襪	的繁体
襬	下襬	的襬	的繁体
襯	襯	托的襯	的繁体
襲	襲	擊的襲	的繁体
襵	(襵	同百褶裙的褶)的繁体
襾	斤襾	的襾	的繁体
覈	(覈	同核心的核)的繁体
覉	(覉	同羈留的羈)的繁体
覊	(覊	同羈留的羈)的繁体
見	看見	的見	的繁体
規	規	則的規	的繁体
覓	覓	食的覓	的繁体
覔	(覔	同覓食的覓)的繁体
覕	(覕	同瞥見的瞥)的繁体
視	視	覺的視	的繁体
覘	覘	標的覘	的繁体
覜	(覜	古時問諸侯的禮)的繁体
覡	(覡	男巫師)的繁体
覦	覬覦	的覦	的繁体
覩	(覩	同目睹的睹)的繁体
親	親	人的親	的繁体
覬	覬	覦的覬	的繁体
覰	(覰	同小覷的覷)的繁体
覲	覲	見的覲	的繁体
覶	覶	縷(把事詳細而委婉的說出)的覶	的繁体
覷	小覷	的覷	的繁体
覺	覺	悟的覺	的繁体
覻	(覻	同小覷的覷)的繁体
覽	遊覽	的覽	的繁体
覿	覿	面的覿	的繁体
觀	觀	看的觀	的繁体
觔	觔	斗(植物名)的觔	的繁体
觝	觝	角之勢的觝	的繁体
觴	觴	酌(酒杯)的觴	的繁体
觵	(觵	同觥船的觥)的繁体
觶	(觶	古代的一種酒器)的繁体
觸	接觸	的觸	的繁体
訂	訂	立的訂	的繁体
訃	訃	文的訃	的繁体
計	計	劃的計	的繁体
訊	資訊	的訊	的繁体
訌	內訌	(內亂或潰敗)的訌	的繁体
討	討	論的討	的繁体
訏	訏	謨的訏	的繁体
訐	攻訐	的訐	的繁体
訑	訑	謾的訑	的繁体
訒	(訒	語言不流暢)的繁体
訓	訓	練的訓	的繁体
訕	搭訕	的訕	的繁体
訖	起訖	的訖	的繁体
託	託	付的託	的繁体
記	記	憶的記	的繁体
訛	訛	傳的訛	的繁体
訝	訝	異的訝	的繁体
訟	訴訟	的訟	的繁体
訢	(訢	同歡欣之欣)的繁体
訣	口訣	的訣	的繁体
訥	木訥	的訥	的繁体
訪	訪	問的訪	的繁体
設	設	計的設	的繁体
許	許	多的許	的繁体
訴	訴	訟的訴	的繁体
訶	訶	額倫的訶	的繁体
診	診	症的診	的繁体
註	註	冊的註	的繁体
証	(証	同證明的證)的繁体
訽	(訽	同詬病的詬)的繁体
訿	(訿	同訾厲的訾)(疾病名)的繁体
詁	訓詁	的詁	的繁体
詆	詆	譭的詆	的繁体
詎	詎	非所料的詎	的繁体
詐	詐	騙的詐	的繁体
詑	(詑	同訑謾的訑)的繁体
詒	(詒	遺留)的繁体
詔	詔	書的詔	的繁体
評	評	論的評	的繁体
詖	詖	辭的詖	的繁体
詗	詗	察的詗	的繁体
詛	詛	咒的詛	的繁体
詞	詞	語的詞	的繁体
詠	歌詠	的詠	的繁体
詡	(詡	說謊)的繁体
詢	詢	問的詢	的繁体
詣	造詣	的詣	的繁体
試	試	驗的試	的繁体
詧	(詧	同觀察的察)的繁体
詩	詩	歌的詩	的繁体
詫	詫	異的詫	的繁体
詬	詬	病的詬	的繁体
詭	詭	計的詭	的繁体
詮	詮	釋的詮	的繁体
詰	詰	責的詰	的繁体
話	說話	的話	的繁体
該	應該	的該	的繁体
詳	詳	細的詳	的繁体
詵	(詵	眾多的樣子)的繁体
詶	(詶	報答)的繁体
詸	(詸	同謎語的謎)的繁体
詼	詼	諧的詼	的繁体
誂	誂	越的誂	的繁体
誄	(誄	哀悼死者的文字)的繁体
誅	誅	滅的誅	的繁体
誆	(誆	說假話)的繁体
誇	誇	獎的誇	的繁体
誌	雜誌	的誌	的繁体
認	認	真的認	的繁体
誑	誑	語的誑	的繁体
誒	(誒	歎息)的繁体
誕	聖誕	的誕	的繁体
誘	誘	惑的誘	的繁体
誚	譏誚	的誚	的繁体
語	語	言的語	的繁体
誠	誠	實的誠	的繁体
誡	十誡	的誡	的繁体
誣	誣	捏的誣	的繁体
誤	誤	會的誤	的繁体
誥	制誥	的誥	的繁体
誦	誦	讀的誦	的繁体
誨	教誨	的誨	的繁体
說	說	話的說	的繁体
誰	誰	人的誰	的繁体
課	課	本的課	的繁体
誶	誶	罵的誶	的繁体
誷	(誷	同罔顧的罔)的繁体
誹	誹	謗的誹	的繁体
誼	友誼	的誼	的繁体
調	調	查的調	的繁体
諂	諂	媚的諂	的繁体
諄	諄	諄	善誘的諄	的繁体
談	談	話的談	的繁体
諉	推諉	(借說話推反)的諉	的繁体
請	請	求的請	的繁体
諍	諍	言的諍	的繁体
諏	諏	訪的諏	的繁体
諐	(諐	同愆行的愆)的繁体
諒	原諒	的諒	的繁体
論	討論	的論	的繁体
諛	阿諛	的諛	的繁体
諜	間諜	的諜	的繁体
諡	諡	忠的諡	的繁体
諢	諢	號(少用)的諢	的繁体
諤	諤	悻的諤	的繁体
諦	詐諦	的諦	的繁体
諧	詼諧	的諧	的繁体
諫	勸諫	的諫	的繁体
諭	口諭	的諭	的繁体
諮	諮	詢的諮	的繁体
諱	避諱	的諱	的繁体
諲	(諲	尊敬)的繁体
諳	熟諳	的諳	的繁体
諶	(姓氏諶	)的繁体
諷	諷	刺的諷	的繁体
諸	諸	侯的諸	的繁体
諺	諺	語的諺	的繁体
諼	(諼	欺騙或欺詐)的繁体
諾	諾	言的諾	的繁体
謀	謀	略的謀	的繁体
謁	謁	見的謁	的繁体
謂	不知所謂	的謂	的繁体
謄	謄	正的謄	的繁体
謅	胡謅	的謅	的繁体
謊	謊	話的謊	的繁体
謌	(謌	同歌曲的歌)的繁体
謎	謎	語的謎	的繁体
謏	謏	聞的謏	的繁体
謐	靜謐	的謐	的繁体
謔	戲謔	的謔	的繁体
謕	(謕	同啼哭的啼)的繁体
謖	(謖	挺起的樣子)的繁体
謗	誹謗	的謗	的繁体
謙	謙	虛的謙	的繁体
謚	謚	號的謚	的繁体
講	講	話的講	的繁体
謝	多謝	的謝	的繁体
謠	謠	言的謠	的繁体
謨	(謨	計策或謀略)的繁体
謩	(謩	同廟謨的謨)的繁体
謫	貶謫	的謫	的繁体
謬	荒謬	的謬	的繁体
謳	謳	歌的謳	的繁体
謹	謹	慎的謹	的繁体
謾	謾	罵的謾	的繁体
譁	(譁	同喧嘩的嘩)的繁体
譆	(譆	同嘻笑的嘻)的繁体
證	證	明的證	的繁体
譊	譊	譊	(喧嘩或呼叫)的譊	的繁体
譎	詭譎	的譎	的繁体
譏	譏	笑的譏	的繁体
譓	義征不譓	的譓	的繁体
譔	(譔	同撰寫的撰)的繁体
譖	讒譖	(說壞話誣陷別人)的譖	的繁体
識	智識	的識	的繁体
譙	譙	周的譙	的繁体
譚	(姓氏譚	)的繁体
譛	(譛	同讒譖的譖)(說壞話誣陷別人)的繁体
譜	譜	寫的譜	的繁体
譟	鼓譟	的譟	的繁体
譫	譫	言的譫	的繁体
譭	詆譭	的譭	的繁体
譯	翻譯	的譯	的繁体
議	議	論的議	的繁体
譴	譴	責的譴	的繁体
護	保護	的護	的繁体
譽	名譽	的譽	的繁体
譾	(譾	淺薄)的繁体
讀	讀	書的讀	的繁体
讁	(讁	同貶謫的謫)的繁体
讇	(讇	同諂媚的諂)的繁体
變	變	化的變	的繁体
讋	(讋	恐懼)的繁体
讌	(讌	同宴會的宴)的繁体
讎	(讎	對答)的繁体
讒	讒	言(說人壞話)的讒	的繁体
讓	讓	步的讓	的繁体
讕	(讕	抵賴或誣陷)的繁体
讖	讖	語(預言)的讖	的繁体
讙	(讙	喧嘩或喜悅)的繁体
讚	讚	美的讚	的繁体
讜	讜	言的讜	的繁体
讞	定讞	的讞	的繁体
讟	怨讟	(怨恨和誹謗)的讟	的繁体
讬	(讬	託付的託的簡寫)的繁体
诐	(诐	詖辭的詖的簡寫)的繁体
谿	(谿	同溪水的溪)的繁体
豀	(豀	同溪澗的溪)的繁体
豈	豈	敢的豈	的繁体
豎	橫豎	的豎	的繁体
豐	豐	富的豐	的繁体
豑	(豑	同秩序的秩)的繁体
豒	(豒	同秩序的秩)的繁体
豓	(豓	同艷麗的艷)的繁体
豔	(豔	同艷麗的艷)的繁体
豗	喧豗	的豗	的繁体
豘	(豘	同海豚的豚)的繁体
豨	豨	薟的豨	的繁体
豬	豬	肉的豬	的繁体
豭	(豭	公豬)的繁体
豮	(豮	豶豬的豶的簡寫)的繁体
豶	(豶	閹割的雄豬)的繁体
豷	(豷	豬喘氣)的繁体
豻	(豻	古代北方野狗)的繁体
貆	(貆	動物名)的繁体
貍	貍	貓的貍	的繁体
貓	貓	狗的貓	的繁体
貝	貝	殼的貝	的繁体
貞	貞	節的貞	的繁体
負	負	責的負	的繁体
財	財	富的財	的繁体
貢	貢	獻的貢	的繁体
貤	流貤	的貤	的繁体
貧	貧	窮的貧	的繁体
貨	貨	物的貨	的繁体
販	販	賣的販	的繁体
貪	貪	心的貪	的繁体
貫	貫	通的貫	的繁体
責	責	任的責	的繁体
貯	貯	藏的貯	的繁体
貰	(貰	出借)的繁体
貲	貲	源的貲	的繁体
貳	(貳	中國數字二的大寫)的繁体
貴	貴	重的貴	的繁体
貶	貶	值的貶	的繁体
買	買	賣的買	的繁体
貸	貸	款的貸	的繁体
貺	貺	祐的貺	的繁体
費	費	用的費	的繁体
貼	貼	上的貼	的繁体
貽	貽	害的貽	的繁体
貿	貿	易的貿	的繁体
賀	恭賀	的賀	的繁体
賁	賁	臨的賁	的繁体
賂	賄賂	的賂	的繁体
賃	租賃	的賃	的繁体
賄	賄	賂的賄	的繁体
賅	言簡意賅	的賅	的繁体
資	資	格的資	的繁体
賈	商賈	的賈	的繁体
賉	(賉	同撫恤的恤)的繁体
賊	盜賊	的賊	的繁体
賌	(賌	同言簡意賅的賅)的繁体
賑	賑	災的賑	的繁体
賒	賒	借的賒	的繁体
賓	賓	客的賓	的繁体
賔	(賔	同賓客的賓)的繁体
賕	(賕	賄賂)的繁体
賙	賙	濟的賙	的繁体
賛	(賛	同贊成的贊)的繁体
賜	賞賜	的賜	的繁体
賞	賞	罰的賞	的繁体
賠	賠	償的賠	的繁体
賡	賡	續提供的賡	的繁体
賢	賢	德的賢	的繁体
賣	買賣	的賣	的繁体
賤	賤	格的賤	的繁体
賦	賦	稅的賦	的繁体
質	質	量的質	的繁体
賬	賬	單的賬	的繁体
賭	賭	博的賭	的繁体
賴	信賴	的賴	的繁体
賸	賸	餘的賸	的繁体
賺	賺	錢的賺	的繁体
賻	賻	儀的賻	的繁体
購	購	買的購	的繁体
賽	比賽	的賽	的繁体
贄	李贄	(人名)的贄	的繁体
贅	贅	述的贅	的繁体
贇	(贇	美好的)的繁体
贈	贈	送的贈	的繁体
贊	贊	成的贊	的繁体
贍	贍	養的贍	的繁体
贏	贏	輸的贏	的繁体
贐	(贐	臨別時送給出行者的財物)的繁体
贒	(贒	同賢德的賢)的繁体
贓	贓	物的贓	的繁体
贖	贖	罪的贖	的繁体
贗	贗	品的贗	的繁体
贛	(贛	江西簡稱)的繁体
赒	(赒	賙濟的賙的簡寫)的繁体
赩	(赩	沒有草木的)的繁体
赮	(赮	同雲霞的霞)的繁体
趂	(趂	趁機的趁的簡寫)的繁体
趕	趕	快的趕	的繁体
趙	(姓氏趙	)的繁体
趦	(趦	同趑趄的趑)的繁体
趨	趨	勢的趨	的繁体
趫	高趫	的趫	的繁体
趬	趬	悍的趬	的繁体
趯	(趯	跳躍)的繁体
跀	(跀	同刖刑的刖)的繁体
跂	(跂	多生出的腳趾)的繁体
跐	(跐	踐踏)的繁体
跡	蹤跡	的跡	的繁体
跥	(跥	同跺腳的跺)的繁体
跦	跦	跦	的跦	的繁体
跩	(跩	搖擺地走)的繁体
跮	(跮	忽然進退的樣子)的繁体
跲	(跲	跌倒)的繁体
跴	跴	揖的跴	的繁体
跼	跼	蹐的跼	的繁体
踁	(踁	同脛骨的脛)的繁体
踆	(踆	遲疑前進的樣子)的繁体
踐	實踐	的踐	的繁体
踡	(踡	拳腳不能伸展)的繁体
踫	(踫	同碰撞的碰)的繁体
踭	手踭	的踭	的繁体
踰	踰	越的踰	的繁体
踴	踴	躍的踴	的繁体
蹌	踉蹌	的蹌	的繁体
蹏	(蹏	同馬蹄的蹄)的繁体
蹐	(蹐	小步)的繁体
蹞	(蹞	同跬步的跬)的繁体
蹟	事蹟	的蹟	的繁体
蹠	跗蹠	的蹠	的繁体
蹣	蹣	跚的蹣	的繁体
蹤	蹤	跡的蹤	的繁体
蹮	(蹮	同蹁躚的躚)(走路盤旋的樣子)的繁体
蹵	(蹵	同蹴鞠的蹴)的繁体
蹷	(蹷	同一蹶不振的蹶)的繁体
蹸	(蹸	同蹂躪的躪)的繁体
蹹	(蹹	同踏步的踏)的繁体
蹺	蹺	起的蹺	的繁体
蹻	蹻	腳的蹻	的繁体
躉	橋躉	的躉	的繁体
躊	躊	躇的躊	的繁体
躋	躋	身的躋	的繁体
躍	踴躍	的躍	的繁体
躑	躑	躅(不前進的意思)的躑	的繁体
躓	躓	礎的躓	的繁体
躕	踟躕	的躕	的繁体
躚	蹁躚	(走路盤旋的樣子)的躚	的繁体
躡	躡	手躡	腳的躡	的繁体
躥	躥	升的躥	的繁体
躩	(躩	急走)的繁体
躪	蹂躪	的躪	的繁体
躱	(躱	同躲藏的躲)的繁体
躳	(躳	同鞠躬的躬)的繁体
軀	軀	體的軀	的繁体
車	汽車	的車	的繁体
軋	軋	鐵的軋	的繁体
軌	軌	道的軌	的繁体
軍	軍	隊的軍	的繁体
軏	(軏	車轅端的橫木)的繁体
軑	(軑	古代車轂端的冒蓋)的繁体
軒	軒	昂的軒	的繁体
軔	發軔	(事情的開始)的軔	的繁体
軚	軚	鎖的軚	的繁体
軛	偷軛	拐騙的軛	的繁体
軟	軟	硬的軟	的繁体
軫	車軫	的軫	的繁体
軸	軸	心的軸	的繁体
軺	乘軺	的軺	的繁体
軻	孟軻	的軻	的繁体
軼	軼	事的軼	的繁体
軾	蘇軾	(人名)的軾	的繁体
軿	(軿	有帷幕的車子)的繁体
輀	靈輀	的輀	的繁体
較	較	量的較	的繁体
輅	輅	曰的輅	的繁体
載	載	運的載	的繁体
輊	軒輊	的輊	的繁体
輋	和輋	的輋	的繁体
輒	動輒	的輒	的繁体
輓	輓	歌的輓	的繁体
輔	輔	導的輔	的繁体
輕	輕	微的輕	的繁体
輛	車輛	的輛	的繁体
輜	輜	重的輜	的繁体
輝	光輝	的輝	的繁体
輞	輞	川的輞	的繁体
輟	輟	學的輟	的繁体
輥	軋輥	的輥	的繁体
輦	鳳輦	的輦	的繁体
輧	(輧	同軿輅的軿)的繁体
輩	輩	份的輩	的繁体
輪	輪	流的輪	的繁体
輯	編輯	的輯	的繁体
輳	輻輳	(人物聚集)的輳	的繁体
輸	輸	入的輸	的繁体
輻	輻	射的輻	的繁体
輾	輾	轉的輾	的繁体
輿	輿	論的輿	的繁体
轂	槳轂	的轂	的繁体
轄	管轄	的轄	的繁体
轅	軒轅	的轅	的繁体
轆	絞轆	的轆	的繁体
轇	轇	轕的轇	的繁体
轉	轉	動的轉	的繁体
轍	重蹈覆轍	的轍	的繁体
轎	轎	車的轎	的繁体
轐	(轐	車軸內設以安車軫的器具)的繁体
轑	轑	陽(地名)的轑	的繁体
轔	車轔	轔	的轔	的繁体
轕	轇轕	的轕	的繁体
轗	(轗	道路不平或比喻不得志)的繁体
轘	轘	刑(古代用車分裂人體的刑罰)的轘	的繁体
轜	(轜	同靈輀的輀)的繁体
轟	炮轟	的轟	的繁体
轢	凌轢	(欺凌)的轢	的繁体
轤	轆轤	的轤	的繁体
辠	(辠	同罪行的罪)的繁体
辢	(辢	同辣椒的辣)的繁体
辤	(辤	同辭職的辭)的繁体
辥	(辥	同薛仁貴的薛)的繁体
辦	辦	法的辦	的繁体
辭	辭	職的辭	的繁体
辮	辮	子的辮	的繁体
辯	辯	論的辯	的繁体
農	農	民的農	的繁体
辴	(辴	笑的樣子)的繁体
迆	(迆	斜行)的繁体
迍	迍	逗的迍	的繁体
迒	(迒	野獸經過的痕跡)的繁体
迯	(迯	同逃跑的逃)的繁体
迴	迴	廊的迴	的繁体
迺	甘迺	迪的迺	的繁体
迻	(迻	同移動的動)的繁体
逈	(逈	同迥然的迥)的繁体
逕	逕	啟者的逕	的繁体
這	這	個的這	的繁体
連	連	接的連	的繁体
逥	(逥	同迴廊的迴)的繁体
逩	(逩	同奔跑的奔)的繁体
逬	(逬	同迸出的迸)的繁体
週	週	年的週	的繁体
進	進	步的進	的繁体
逴	(逴	遠)的繁体
遊	遊	覽的遊	的繁体
運	運	動的運	的繁体
過	過	去的過	的繁体
達	達	到的達	的繁体
違	違	反的違	的繁体
遙	遙	遠的遙	的繁体
遜	謙遜	的遜	的繁体
遝	雜遝	的遝	的繁体
遞	遞	交的遞	的繁体
遟	(遟	同遲早的遲)的繁体
遠	遠	近的遠	的繁体
適	適	合的適	的繁体
遬	(遬	同速度的速)的繁体
遲	遲	早的遲	的繁体
遶	白水遶	東城的遶	的繁体
遷	遷	居的遷	的繁体
選	選	舉的選	的繁体
遺	遺	失的遺	的繁体
遼	遼	闊的遼	的繁体
邁	豪邁	的邁	的繁体
還	還	原的還	的繁体
邇	遐邇	的邇	的繁体
邊	邊	緣的邊	的繁体
邍	(邍	同原來的原)的繁体
邏	邏	輯的邏	的繁体
邐	迤邐	的邐	的繁体
邠	(邠	同彬彬有禮的彬)的繁体
邨	屋邨	(香港常用)的邨	的繁体
邲	(邲	地名)的繁体
郃	郃	陽(地名)的郃	的繁体
郉	(郉	同邢魁山的邢)的繁体
郘	(郘	古邑名)的繁体
郚	(郚	古邑名)的繁体
郞	(郞	同牛郎的郎)的繁体
郟	(郟	古邑名)的繁体
郤	(郤	古地名)的繁体
郪	郪	江的郪	的繁体
郵	郵	局的郵	的繁体
郿	郿	縣(舊縣名)的郿	的繁体
鄆	鄆	城縣的鄆	的繁体
鄉	鄉	村的鄉	的繁体
鄒	(姓氏鄒	)的繁体
鄔	(姓氏鄔	)的繁体
鄕	(鄕	同鄉村的鄉)的繁体
鄗	(鄗	古地名)的繁体
鄘	(鄘	古國名)的繁体
鄚	鄚	州的鄚	的繁体
鄜	鄜	縣的鄜	的繁体
鄠	鄠	縣的鄠	的繁体
鄧	(姓氏鄧	)的繁体
鄭	鄭	重的鄭	的繁体
鄰	鄰	居的鄰	的繁体
鄲	邯鄲	的鄲	的繁体
鄴	鄴	城的鄴	的繁体
鄺	(姓氏鄺	)的繁体
酈	酈	食其的酈	的繁体
酔	(酔	同麻醉的醉)的繁体
酕	(酕	大醉)的繁体
酦	(酦	醱酵的醱的簡寫)的繁体
酳	(酳	飲食結束後用酒漱口)的繁体
酺	(酺	聚會喝酒)的繁体
醃	醃	製的醃	的繁体
醕	(醕	同甲醇的醇)的繁体
醜	醜	陋的醜	的繁体
醞	醞	釀的醞	的繁体
醡	醡	漿草的醡	的繁体
醫	醫	生的醫	的繁体
醬	醬	油的醬	的繁体
醰	醰	醰	(滋味濃厚的樣子)的醰	的繁体
醱	(醱	釀酒的意思)的繁体
醲	(醲	濃厚或濃郁)的繁体
醻	(醻	同酬謝的酬)的繁体
醼	(醼	同宴會的宴)的繁体
醾	酴醾	(重釀的酒)的醾	的繁体
醿	(醿	同酴醾的醾)(重釀的酒)的繁体
釀	釀	酒的釀	的繁体
釁	挑釁	的釁	的繁体
釂	(釂	喝乾酒杯裏的酒)的繁体
釃	(釃	濾酒)的繁体
釅	釅	醋的釅	的繁体
釆	納釆	的釆	的繁体
釋	解釋	的釋	的繁体
釐	釐	定的釐	的繁体
釓	(釓	金屬名)的繁体
釔	(釔	金屬名稱)的繁体
釕	(釕	化學元素)的繁体
釗	(釗	人名常用)的繁体
釘	碰釘	的釘	的繁体
釙	(釙	金屬名稱)的繁体
針	針	線的針	的繁体
釣	釣	魚的釣	的繁体
釤	(釤	金屬元素名)的繁体
釦	(釦	同鈕扣的扣)的繁体
釧	銀釧	的釧	的繁体
釩	(釩	金屬原素)的繁体
釬	(釬	一頭尖的長鋼棍)的繁体
釭	(釭	燈之意思)的繁体
釵	金釵	的釵	的繁体
釷	(釷	放射元素名)的繁体
釹	(釹	金屬元素名)的繁体
鈁	(鈁	金屬元素名)的繁体
鈆	(鈆	同鉛筆的鉛)的繁体
鈇	鈇	鑽(刑罰)的鈇	的繁体
鈉	(鈉	金屬名)的繁体
鈍	遲鈍	的鈍	的繁体
鈎	鈎	織的鈎	的繁体
鈐	鈐	記的鈐	的繁体
鈔	鈔	票的鈔	的繁体
鈕	鈕	扣的鈕	的繁体
鈞	千鈞	一髮的鈞	的繁体
鈣	(鈣	金屬名)的繁体
鈥	(鈥	金屬元素名)的繁体
鈦	(鈦	金屬名)的繁体
鈧	(鈧	金屬元素名)的繁体
鈴	門鈴	的鈴	的繁体
鈷	(鈷	金屬名稱)的繁体
鈸	鐃鈸	的鈸	的繁体
鈹	鈹	等之的鈹	的繁体
鈺	(鈺	堅硬的金屬)的繁体
鈾	(鈾	金屬名)的繁体
鉀	(鉀	金屬名)的繁体
鉅	鉅	款的鉅	的繁体
鉈	(鉈	金屬名)的繁体
鉉	鉉	台的鉉	的繁体
鉋	鉋	床的鉋	的繁体
鉍	(鉍	金屬名)的繁体
鉑	(鉑	金屬名即白金)的繁体
鉗	鉗	子的鉗	的繁体
鉚	鉚	釘的鉚	的繁体
鉛	(鉛	金屬名稱)的繁体
鉢	鉢	頭的鉢	的繁体
鉤	魚鉤	的鉤	的繁体
鉦	鉦	鼓的鉦	的繁体
鉩	(鉩	同玉璽的璽)的繁体
鉬	(鉬	金屬名)的繁体
鉶	(鉶	古代盛羹的器具)的繁体
鉸	鉸	剪的鉸	的繁体
鉺	(鉺	金屬元素名)的繁体
鉻	(鉻	金屬名)的繁体
鉿	(鉿	金屬元素名)的繁体
銀	銀	行的銀	的繁体
銅	銅	幣的銅	的繁体
銍	(銍	短的鐮刀)的繁体
銑	銑	床的銑	的繁体
銓	銓	敘的銓	的繁体
銖	銖	錢的銖	的繁体
銘	銘	記的銘	的繁体
銚	(銚	有柄的小鍋)的繁体
銛	(銛	古代一種兵器)的繁体
銜	銜	頭的銜	的繁体
銠	(銠	金屬元素名)的繁体
銣	(銣	金屬元素名)的繁体
銥	(銥	金屬名)的繁体
銦	(銦	金屬元素名)的繁体
銧	(銧	化學元素)的繁体
銨	(銨	化學名)的繁体
銩	(銩	金屬元素名)的繁体
銪	(銪	金屬元素名)的繁体
銫	(銫	金屬元素名)的繁体
銬	手銬	的銬	的繁体
銲	銲	錫的銲	的繁体
銳	銳	氣的銳	的繁体
銷	銷	售的銷	的繁体
銹	(銹	生鏽的鏽的香港寫法)的繁体
銻	(銻	金屬名稱)的繁体
銼	三角銼	的銼	的繁体
鋁	(鋁	金屬名)的繁体
鋃	鋃	鐺的鋃	的繁体
鋅	(鋅	金屬名)的繁体
鋇	(鋇	金屬名)的繁体
鋌	鋌	而走險的鋌	的繁体
鋒	鋒	利的鋒	的繁体
鋛	鋛	鰂魚的鋛	的繁体
鋜	(鋜	同金鐲的鐲)的繁体
鋤	鋤	頭的鋤	的繁体
鋩	鋩	鑼的鋩	的繁体
鋪	鋪	張的鋪	的繁体
鋮	(鋮	用於人名)的繁体
鋯	(鋯	金屬名)的繁体
鋰	(鋰	金名素)的繁体
鋸	鋸	齒的鋸	的繁体
鋼	鋼	鐵的鋼	的繁体
錄	記錄	的錄	的繁体
錐	圓錐	的錐	的繁体
錒	(錒	化學元素名)的繁体
錕	小錕	的錕	的繁体
錘	鐵錘	的錘	的繁体
錙	錙	銖必較的錙	的繁体
錚	錚	錚	的錚	的繁体
錠	金錠	的錠	的繁体
錡	(錡	古時三足的鍋)的繁体
錢	錢	幣的錢	的繁体
錦	錦	繡的錦	的繁体
錨	拋錨	的錨	的繁体
錫	(錫	金屬名)的繁体
錬	(錬	同拉鍊的鍊)的繁体
錮	禁錮	的錮	的繁体
錯	錯	誤的錯	的繁体
錳	(錳	金屬名)的繁体
錶	鐘錶	的錶	的繁体
錸	錸	德的錸	的繁体
鍈	陳樹鍈	的鍈	的繁体
鍊	拉鍊	的鍊	的繁体
鍋	鍋	爐的鍋	的繁体
鍍	電鍍	的鍍	的繁体
鍔	蔡鍔	(人名)的鍔	的繁体
鍘	鍘	刀的鍘	的繁体
鍚	(鍚	馬頭上的金屬飾物)的繁体
鍛	鍛	鍊的鍛	的繁体
鍥	鍥	而不捨的鍥	的繁体
鍬	鐵鍬	的鍬	的繁体
鍰	(鍰	古代的重量單位)的繁体
鍳	(鍳	同台鑒的鑒)的繁体
鍵	鍵	盤的鍵	的繁体
鍼	鍼	黹的鍼	的繁体
鍾	鍾	愛的鍾	的繁体
鎂	(鎂	金屬名)的繁体
鎊	英鎊	的鎊	的繁体
鎋	(鎋	同管轄的轄)的繁体
鎌	鎌	倉的鎌	的繁体
鎔	鎔	化的鎔	的繁体
鎖	鎖	匙的鎖	的繁体
鎗	(鎗	同槍炮的槍)的繁体
鎘	(鎘	金屬元素名)的繁体
鎚	(鎚	同鐵錘的錘)的繁体
鎢	(鎢	金屬名)的繁体
鎧	鎧	甲的鎧	的繁体
鎩	鎩	羽而歸的鎩	的繁体
鎬	鎬	京的鎬	的繁体
鎭	(鎭	同鎮定的鎮)的繁体
鎮	鎮	定的鎮	的繁体
鎰	(鎰	古代重量單位)的繁体
鎳	(鎳	金屬名)的繁体
鎻	(鎻	同鎖匙的鎖)的繁体
鏁	(鏁	同鎖匙的鎖)的繁体
鏃	飛鏃	的鏃	的繁体
鏇	鏇	粉(溫酒的器具)的鏇	的繁体
鏈	鎖鏈	的鏈	的繁体
鏌	(鏌	古代名劍)的繁体
鏐	(鏐	成色好的金子)的繁体
鏑	(鏑	金屬名)的繁体
鏗	鏗	鏘的鏗	的繁体
鏘	鏗鏘	的鏘	的繁体
鏚	(鏚	斧頭)的繁体
鏜	鏜	孔的鏜	的繁体
鏝	泥鏝	的鏝	的繁体
鏞	鏞	記酒家的鏞	的繁体
鏟	鐵鏟	的鏟	的繁体
鏠	(鏠	同鋒利的鋒)的繁体
鏡	鏡	片的鏡	的繁体
鏢	飛鏢	的鏢	的繁体
鏤	金鏤	衣的鏤	的繁体
鏦	鏦	鏦	錚錚的鏦	的繁体
鏨	石鏨	的鏨	的繁体
鏬	(鏬	同罅隙的罅)的繁体
鏮	(鏮	化學名)的繁体
鏵	泥鏵	的鏵	的繁体
鏷	(鏷	金屬名)的繁体
鏹	冥鏹	的鏹	的繁体
鏺	(鏺	一種似鐮刀的農具)的繁体
鏽	(鏽	生銹的銹的繁體字)的繁体
鐀	(鐀	同民窮財匱的匱)的繁体
鐃	鐃	鈸的鐃	的繁体
鐋	鐋	鑼的鐋	的繁体
鐍	(鐍	箱子上安鎖的金屬環)的繁体
鐐	手鐐	的鐐	的繁体
鐒	(鐒	放射牲元素)的繁体
鐘	鐘	錶的鐘	的繁体
鐙	鐙	骨切除術的鐙	的繁体
鐠	(鐠	金屬名)的繁体
鐫	鐫	刻的鐫	的繁体
鐮	鐮	刀的鐮	的繁体
鐲	金鐲	的鐲	的繁体
鐳	(鐳	金屬名)的繁体
鐵	鐵	路的鐵	的繁体
鐶	(鐶	中間有孔的金屬圓形物)的繁体
鐸	木鐸	的鐸	的繁体
鐺	鈴鐺	的鐺	的繁体
鐿	(鐿	金屬名)的繁体
鑄	鑄	鐵的鑄	的繁体
鑊	鐵鑊	的鑊	的繁体
鑌	鑌	鐵的鑌	的繁体
鑑	鑑	定的鑑	的繁体
鑒	(鑒	同鑑定的鑑)的繁体
鑕	(鑕	古代斬人的刑具)的繁体
鑚	(鑚	同鑽石的鑽)的繁体
鑞	(鑞	鍚和鉛的合金)的繁体
鑠	鑠	金的鑠	的繁体
鑣	保鑣	的鑣	的繁体
鑤	鑤	子的鑤	的繁体
鑪	(鑪	同火爐的爐)的繁体
鑭	(鑭	金屬名)的繁体
鑰	鑰	匙的鑰	的繁体
鑲	鑲	嵌的鑲	的繁体
鑷	眉鑷	的鑷	的繁体
鑼	鑼	鼓的鑼	的繁体
鑽	鑽	石的鑽	的繁体
鑾	金鑾	大殿的鑾	的繁体
鑿	開鑿	的鑿	的繁体
钁	钁	頭(挖土石和野草的農具)的钁	的繁体
钂	钂	鈀(古代兵器)的钂	的繁体
铇	(铇	刨木的刨的簡寫)的繁体
铓	(铓	鋩鑼的鋩的簡寫)的繁体
锜	(锜	周汶錡的錡的簡寫)的繁体
锳	(锳	陳樹鍈的鍈的簡寫)的繁体
镋	(镋	钂鈀的钂的簡寫)(古代兵器)的繁体
镕	(镕	鎔化的鎔的簡寫)的繁体
長	長	短的長	的繁体
門	門	戶的門	的繁体
閂	門閂	的閂	的繁体
閃	閃	電的閃	的繁体
閆	(閆	同閻皇的閻)的繁体
閉	關閉	的閉	的繁体
開	開	關的開	的繁体
閏	閏	月的閏	的繁体
閑	閑	置住宅的閑	的繁体
閒	閒	談的閒	的繁体
間	中間	的間	的繁体
閔	閔	念的閔	的繁体
閘	閘	門的閘	的繁体
閙	(閙	同熱鬧的鬧)的繁体
閡	隔閡	的閡	的繁体
関	(関	同關係的關)的繁体
閣	閣	樓的閣	的繁体
閥	軍閥	的閥	的繁体
閧	(閧	同哄騙的哄)的繁体
閨	閨	房的閨	的繁体
閩	(閩	福建省的簡稱)的繁体
閬	閬	中的閬	的繁体
閭	三閭	大夫的閭	的繁体
閱	閱	讀的閱	的繁体
閶	閶	闔門(天門)的閶	的繁体
閹	閹	割的閹	的繁体
閻	閻	王的閻	的繁体
閼	閼	氏的閼	的繁体
閾	聽閾	的閾	的繁体
闆	老闆	的闆	的繁体
闇	闇	魔的闇	的繁体
闈	宮闈	的闈	的繁体
闊	寬闊	的闊	的繁体
闋	一闋	歌曲的闋	的繁体
闌	闌	珊的闌	的繁体
闐	闐	闐	的闐	的繁体
闑	(闑	古代門中央豎立的短木)的繁体
闒	(闒	樓上的門)的繁体
闓	(闓	開啟)的繁体
闔	闔	府糸玄山占扛月的闔	的繁体
闕	宮闕	的闕	的繁体
闖	闖	將的闖	的繁体
闚	(闚	利誘或窺看)的繁体
關	關	係的關	的繁体
闝	(闝	同嫖妓的嫖)的繁体
闞	(闞	俯視)的繁体
闡	闡	釋的闡	的繁体
闢	開闢	的闢	的繁体
闥	(闥	小門)的繁体
闿	(闿	闓闡的闓的簡寫)的繁体
阘	(阘	闒茸的闒的簡寫)(卑微)的繁体
阞	(阞	地的脈理)的繁体
阤	阤	靡的阤	的繁体
阧	(阧	同陡峭的陡)的繁体
阨	(阨	險要的地方)的繁体
阬	(阬	大土山)的繁体
阯	(阯	同地址的趾)的繁体
阸	(阸	同厄運的厄)的繁体
陖	(陖	同峻嶺的峻)的繁体
陗	(陗	同峭壁的峭)的繁体
陘	(陘	山脈中斷的地方)的繁体
陜	陜	西(陝西的俗寫)的陜	的繁体
陝	陝	西的陝	的繁体
陞	晉陞	的陞	的繁体
陣	陣	容的陣	的繁体
陰	陰	暗的陰	的繁体
陳	陳	舊的陳	的繁体
陸	陸	地的陸	的繁体
陼	(陼	同渚槽的渚)的繁体
陽	太陽	的陽	的繁体
陿	(陿	同狹窄的狹)的繁体
隁	(隁	同塘堰的堰)的繁体
隂	(隂	同陰暗的陰)的繁体
隃	(隃	遙遠)的繁体
隄	隄	備的隄	的繁体
隉	阢隉	不安的隉	的繁体
隊	隊	伍的隊	的繁体
階	階	級的階	的繁体
隕	隕	石的隕	的繁体
際	實際	的際	的繁体
隝	(隝	同島嶼的島)的繁体
隥	(隥	同磴道的磴)的繁体
隨	隨	意的隨	的繁体
險	危險	的險	的繁体
隫	(隫	同墳墓的墳)的繁体
隱	隱	藏的隱	的繁体
隴	(隴	甘肅的簡稱)的繁体
隷	(隷	同隸屬的隸)的繁体
隸	隸	屬的隸	的繁体
隺	(隺	同白鶴的鶴)的繁体
隻	隻	身的隻	的繁体
雊	(雊	雉雞叫)的繁体
雋	雋	永的雋	的繁体
雔	雔	鴛的雔	的繁体
雖	雖	然的雖	的繁体
雘	丹雘	(赤石脂之類可作顏料)的雘	的繁体
雙	雙	方的雙	的繁体
雛	雛	型的雛	的繁体
雜	複雜	的雜	的繁体
雝	雝	渠(鳥名)的雝	的繁体
雞	雞	蛋的雞	的繁体
雟	子巂(杜鵑)的雟	的繁体
離	離	開的離	的繁体
難	困難	的難	的繁体
雧	(雧	同集中的集)的繁体
雰	(雰	同氣氛的氛)的繁体
雱	(雱	大雨或大雪的樣子)的繁体
雲	風雲	的雲	的繁体
雺	(雺	同雲霧的霧)的繁体
電	電	力的電	的繁体
霂	霢霂	(小雨)的霂	的繁体
霑	汗濕霑	背的霑	的繁体
霠	(霠	同陰暗的陰)的繁体
霣	(霣	同隕石的隕)的繁体
霧	雲霧	的霧	的繁体
霨	(霨	雲起的樣子)的繁体
霩	(霩	雲罷雨止的樣子)的繁体
霽	霽	月的霽	的繁体
霿	(霿	同雲霧的霧)的繁体
靁	(靁	同雷電的雷)的繁体
靂	霹靂	的靂	的繁体
靄	雲靄	靄	的靄	的繁体
靆	靉靆	(雲盛的樣子)的靆	的繁体
靈	靈	魂的靈	的繁体
靉	靉	靉	(雲濃厚的樣子)的靉	的繁体
靑	(靑	同青草的青)的繁体
靚	靚	人的靚	的繁体
靜	安靜	的靜	的繁体
靣	(靣	同面積的面)的繁体
靤	(靤	同疱疹的疱)的繁体
靦	靦	腆的靦	的繁体
靨	笑靨	(即酒窩)的靨	的繁体
靪	補靪	的靪	的繁体
靭	(靭	同韌力的韌)的繁体
靰	靰	鞡的靰	的繁体
靱	(靱	同韌力的韌)的繁体
靷	(靷	草制的鞋)的繁体
靸	(靸	拖鞋)的繁体
靺	靺	鞨的靺	的繁体
靽	(靽	駕車時套在牲口後的皮帶)的繁体
靾	(靾	馬繮繩)的繁体
靿	(靿	襪筒)的繁体
鞀	鞀	鼓(有柄的小鼓)的鞀	的繁体
鞁	(鞁	古時套車用的器具)的繁体
鞃	(鞃	古代車軾中段的橫木)的繁体
鞌	(鞌	同馬鞍的鞍)的繁体
鞏	鞏	固的鞏	的繁体
鞥	(鞥	馬繮)的繁体
鞦	鞦	韆的鞦	的繁体
鞨	(鞨	鞋)的繁体
鞬	鞬	服(馬上盛弓箭的器具)的鞬	的繁体
鞮	鞮	譯(古代的一種皮鞋)的鞮	的繁体
鞳	(鞳	鐘鼓的聲音)的繁体
鞵	(鞵	同皮鞋的鞋)的繁体
鞶	(鞶	皮造的腰帶)的繁体
鞹	(鞹	皮革)的繁体
鞾	(鞾	同皮靴的靴)的繁体
韁	馬韁	的韁	的繁体
韃	韃	子的韃	的繁体
韆	鞦韆	的韆	的繁体
韈	(韈	同鞋襪的襪)的繁体
韉	(韉	馬鞍上的墊褥)的繁体
韋	(姓氏韋	)的繁体
韌	韌	力的韌	的繁体
韒	(韒	同劍鞘的鞘)的繁体
韓	韓	國的韓	的繁体
韘	(韘	射箭用具)的繁体
韙	冒天下之大不韙	的韙	的繁体
韜	韜	略的韜	的繁体
韝	韝	下的韝	的繁体
韞	(韞	收藏或蘊藏)的繁体
韤	(韤	同鞋襪的襪)的繁体
韮	韮	菜的韮	的繁体
韻	韻	律的韻	的繁体
響	響	應的響	的繁体
頁	一頁	書的頁	的繁体
頂	頂	天立地的頂	的繁体
頃	頃	刻的頃	的繁体
頄	(頄	顴骨)的繁体
項	項	目的項	的繁体
順	順	利的順	的繁体
頇	頇	槓子的頇	的繁体
須	須	知的須	的繁体
頌	歌頌	的頌	的繁体
頎	(頎	身材高大)的繁体
預	預	備的預	的繁体
頑	頑	皮的頑	的繁体
頒	頒	獎的頒	的繁体
頓	停頓	的頓	的繁体
頖	頖	宮的頖	的繁体
頗	頗	為的頗	的繁体
領	領	導的領	的繁体
頜	上頜	的頜	的繁体
頟	(頟	同額頭的額)的繁体
頡	倉頡	的頡	的繁体
頤	頤	和園的頤	的繁体
頦	(頦	下巴)的繁体
頫	趙孟頫	的頫	的繁体
頭	頭	腦的頭	的繁体
頰	面頰	的頰	的繁体
頷	頷	首的頷	的繁体
頸	頸	項的頸	的繁体
頹	頹	廢的頹	的繁体
頻	頻	率的頻	的繁体
頿	(頿	同髭鬚的髭)的繁体
顆	顆	粒的顆	的繁体
顇	(顇	同憔悴的悴)的繁体
題	題	目的題	的繁体
額	額	頭的額	的繁体
顎	顎	骨的顎	的繁体
顏	顏	色的顏	的繁体
顐	(顐	同諢號的諢)(少用)的繁体
顑	顑	頷(面貌憔悴)的顑	的繁体
顒	顒	望(昂頭景仰)的顒	的繁体
顓	顓	蒙的顓	的繁体
顗	(顗	謹慎端莊的樣子)的繁体
願	願	望的願	的繁体
顙	(顙	額頭)的繁体
顚	(顚	同顛倒的顛)的繁体
顛	顛	倒的顛	的繁体
類	種類	的類	的繁体
顢	(顢	糊塗不明事理)的繁体
顥	顥	示的顥	的繁体
顧	顧	客的顧	的繁体
顨	(顨	同巽卦的巽)的繁体
顫	顫	抖的顫	的繁体
顯	顯	注的顯	的繁体
顰	東施效顰	的顰	的繁体
顱	頭顱	的顱	的繁体
顳	顳	葉的顳	的繁体
顴	顴	骨的顴	的繁体
颕	(颕	聰穎的穎的簡寫)的繁体
颙	(颙	顒望的顒的簡寫)(昂頭景仰)的繁体
風	風	景的風	的繁体
颭	(颭	風吹動物体使顫動)的繁体
颯	秋風颯	颯	的颯	的繁体
颱	颱	風的颱	的繁体
颳	颳	大風的颳	的繁体
颶	颶	風的颶	的繁体
颸	颸	颸	(涼風或疾風)的颸	的繁体
颺	颺	颺	(飛的樣子)的颺	的繁体
颻	(颻	搖擺)的繁体
颼	風聲颼	颼	的颼	的繁体
颿	(颿	同帆船的帆)的繁体
飀	(飀	微風吹動的樣子)的繁体
飃	(飃	同飄逸的飄)的繁体
飄	飄	逸的飄	的繁体
飆	飆	升的飆	的繁体
飏	(飏	颺颺的颺的簡寫)(飛的樣子)的繁体
飔	(飔	颸颸的颸的簡寫)(涼風或疾風)的繁体
飖	(飖	颻颺的颻的簡寫)的繁体
飛	飛	機的飛	的繁体
飢	(飢	饑俄的饑的簡寫)的繁体
飣	餖飣	的飣	的繁体
飤	(飤	同飼養的飼)的繁体
飥	餺飥	(湯餅)的飥	的繁体
飩	餛飩	的飩	的繁体
飪	烹飪	的飪	的繁体
飫	飫	飽的飫	的繁体
飭	飭	令的飭	的繁体
飮	(飮	同飲食的飲)的繁体
飯	米飯	的飯	的繁体
飰	(飰	同米飯的飯)的繁体
飲	飲	食的飲	的繁体
飴	飴	糖的飴	的繁体
飼	飼	養的飼	的繁体
飽	飽	滿的飽	的繁体
飾	裝飾	的飾	的繁体
餁	(餁	同烹飪的飪)的繁体
餂	(餂	探取或套騙)的繁体
餃	水餃	的餃	的繁体
餅	餅	乾的餅	的繁体
餉	差餉	的餉	的繁体
養	養	殖的養	的繁体
餌	魚餌	的餌	的繁体
餑	餑	餑	(麵做的餅)的餑	的繁体
餒	棄餒	的餒	的繁体
餓	饑餓	的餓	的繁体
餔	餔	歠(喝飲)的餔	的繁体
餘	餘	額的餘	的繁体
餚	菜餚	的餚	的繁体
餛	餛	飩的餛	的繁体
餞	蜜餞	的餞	的繁体
餠	(餠	同餅乾的餅)的繁体
餡	餡	餅的餡	的繁体
餧	(餧	同餵食的餵)的繁体
館	飯館	的館	的繁体
餬	餬	口的餬	的繁体
餱	餱	墣的餱	的繁体
餵	餵	食的餵	的繁体
餸	餸	菜的餸	的繁体
餺	餺	飥(湯餅)的餺	的繁体
餼	(餼	贈送給人的糧食)的繁体
餽	(餽	同饋贈的饋)的繁体
餾	蒸餾	的餾	的繁体
餿	餿	水的餿	的繁体
饁	(饁	送飯給在田裡工作的人吃)的繁体
饃	饃	饃	(北方食物)的饃	的繁体
饅	饅	頭的饅	的繁体
饇	如食宜饇	(飽)的饇	的繁体
饈	珍饈	百味的饈	的繁体
饉	饑饉	的饉	的繁体
饋	饋	贈的饋	的繁体
饌	饌	珍的饌	的繁体
饑	饑	餓的饑	的繁体
饒	饒	恕的饒	的繁体
饗	饗	宴的饗	的繁体
饜	無饜	的饜	的繁体
饝	(饝	同饃饃的饃)(北方食物)的繁体
饞	饞	嘴的饞	的繁体
饟	饟	巴圖爾的饟	的繁体
饤	(饤	餖飣的飣的簡寫)的繁体
饦	(饦	餺飥的飥的簡寫)(湯餅)的繁体
馎	(馎	餺飥的餺的簡寫)(湯餅)的繁体
馝	(馝	極香)的繁体
馬	馬	匹的馬	的繁体
馭	駕馭	的馭	的繁体
馮	(姓氏馮	)的繁体
馱	馱	着的馱	的繁体
馳	馳	名的馳	的繁体
馴	馴	服的馴	的繁体
馹	(馹	古代驛站所用的驛車)的繁体
駁	接駁	的駁	的繁体
駃	(駃	駿馬)的繁体
駈	(駈	同驅逐的驅)的繁体
駐	駐	守的駐	的繁体
駑	駑	鈍的駑	的繁体
駒	神駒	的駒	的繁体
駕	駕	駛的駕	的繁体
駙	駙	馬的駙	的繁体
駛	駕駛	的駛	的繁体
駝	駱駝	的駝	的繁体
駞	(駞	同駱駝的駝)的繁体
駟	駟	馬難追的駟	的繁体
駡	(駡	同責罵的罵)的繁体
駢	駢	文的駢	的繁体
駬	騄駬	(周穆王八駿馬之一)的駬	的繁体
駭	駭	人的駭	的繁体
駱	駱	駝的駱	的繁体
駼	騊駼	(一種良馬)的駼	的繁体
駿	駿	馬的駿	的繁体
騁	馳騁	的騁	的繁体
騄	騄	駬(周穆王八駿馬之一)的騄	的繁体
騅	(騅	白黑相雜的馬)的繁体
騈	(騈	同駢文的駢)的繁体
騉	騉	蹄(蹄平正善登高的良馬)的騉	的繁体
騊	騊	駼(一種良馬)的騊	的繁体
騋	騋	牝(七尺以上的馬)的騋	的繁体
騍	騍	馬(母馬)的騍	的繁体
騎	騎	馬的騎	的繁体
騏	(騏	青黑色的馬)的繁体
騑	(騑	古代在兩旁拉車的馬)的繁体
騕	騕	褭(古代駿馬名)的騕	的繁体
騖	好高騖	遠的騖	的繁体
騙	欺騙	的騙	的繁体
騠	駛騠	的騠	的繁体
騢	(騢	毛色赤白相雜的馬)的繁体
騣	(騣	同鬃毛的鬃)的繁体
騤	騤	騤	(馬行走威儀盛壯)的騤	的繁体
騧	(騧	黑嘴的黃馬)的繁体
騫	張騫	(人名)的騫	的繁体
騭	(騭	公馬)的繁体
騮	馬騮	的騮	的繁体
騰	奔騰	的騰	的繁体
騵	(騵	紅色白腹的馬)的繁体
騶	(騶	古代替貴族掌管車馬的人)的繁体
騷	騷	擾的騷	的繁体
騸	(騸	割掉牲畜的睪丸或卵巢)的繁体
騹	(騹	同騏驥的騏)的繁体
騾	捱騾	仔的騾	的繁体
驀	驀	然的驀	的繁体
驁	(驁	駿馬)的繁体
驂	(驂	古代指在兩旁駕車的馬)的繁体
驃	驃	騎的驃	的繁体
驄	驄	馬的驄	的繁体
驅	驅	逐的驅	的繁体
驊	驊	騮(周穆王八駿馬之一)的驊	的繁体
驌	驌	驦的驌	的繁体
驍	驍	勇的驍	的繁体
驏	(驏	不加鞍轡的馬)的繁体
驕	驕	傲的驕	的繁体
驗	檢驗	的驗	的繁体
驚	驚	慌的驚	的繁体
驛	驛	站的驛	的繁体
驟	步驟	的驟	的繁体
驢	驢	子的驢	的繁体
驥	按圖索驥	的驥	的繁体
驦	驌驦	的驦	的繁体
驨	躞驨	的驨	的繁体
驪	驪	山的驪	的繁体
骔	(骔	鬃毛的鬃的簡寫)的繁体
骕	(骕	驌驦的驌的簡寫)的繁体
骙	(骙	騤騤的騤的簡寫)(馬行走威儀盛壯)的繁体
骦	(骦	驌驦的驦的簡寫)的繁体
骯	骯	髒的骯	的繁体
骻	骻	骨的骻	的繁体
骽	(骽	同火腿的腿)的繁体
髈	(髈	同肩膀的膀)的繁体
髏	骷髏	骨的髏	的繁体
髒	骯髒	的髒	的繁体
體	體	育的體	的繁体
髕	(髕	古代削去膝蓋的刑罰)的繁体
髖	髖	骨的髖	的繁体
髙	(髙	同高低的高)的繁体
髣	(髣	好像)的繁体
髥	(髥	同虯髯的髯)的繁体
髩	(髩	同鬢髮的鬢)的繁体
髮	頭髮	的髮	的繁体
髽	髽	髻的髽	的繁体
鬀	(鬀	同剃刀的剃)的繁体
鬁	(鬁	同瘌痢的痢)的繁体
鬄	(鬄	古代剃去頭髮的刑罰)的繁体
鬅	鬅	鬆(形容髮亂)的鬅	的繁体
鬆	鬆	懈的鬆	的繁体
鬉	(鬉	同鬃毛的鬃)的繁体
鬍	鬍	鬚的鬍	的繁体
鬎	(鬎	同瘌痢的瘌)的繁体
鬐	(鬐	馬頸上部的毛)的繁体
鬒	(鬒	髮黑而稠密美好)的繁体
鬘	華鬘	(形容頭髮美好)的鬘	的繁体
鬚	鬍鬚	的鬚	的繁体
鬢	鬢	髮的鬢	的繁体
鬥	鬥	爭的鬥	的繁体
鬦	(鬦	同鬥爭的鬥)的繁体
鬧	熱鬧	的鬧	的繁体
鬨	起鬨	(吵鬧或擾亂)的鬨	的繁体
鬩	鬩	牆的鬩	的繁体
鬪	(鬪	同鬥爭的鬥)的繁体
鬬	(鬬	同鬥爭的鬥)的繁体
鬮	拈鬮	的鬮	的繁体
鬱	鬱	悶的鬱	的繁体
鬽	(鬽	同魅力的魅)的繁体
魊	鬼魊	的魊	的繁体
魋	(魋	動物名)的繁体
魎	魍魎	的魎	的繁体
魘	夢魘	的魘	的繁体
魚	魚	類的魚	的繁体
魟	魟	魚的魟	的繁体
魯	魯	莽的魯	的繁体
魴	烏魴	的魴	的繁体
魷	魷	魚的魷	的繁体
鮑	鮑	魚的鮑	的繁体
鮓	白鮓	的鮓	的繁体
鮪	鮪	魚的鮪	的繁体
鮫	鮫	魚的鮫	的繁体
鮭	鮭	魚的鮭	的繁体
鮮	新鮮	的鮮	的繁体
鮷	(鮷	同鯷魚的鯷)的繁体
鮸	(鮸	魚名)的繁体
鯀	(鯀	大魚)的繁体
鯁	鯁	骨的鯁	的繁体
鯇	鯇	魚的鯇	的繁体
鯉	鯉	魚的鯉	的繁体
鯊	鯊	魚的鯊	的繁体
鯔	鯔	魚(魚名)的鯔	的繁体
鯖	鯖	魚的鯖	的繁体
鯗	鯗	魚的鯗	的繁体
鯛	鯛	魚的鯛	的繁体
鯢	(鯢	娃娃魚)的繁体
鯤	(鯤	傳說中一種大魚)的繁体
鯧	鯧	魚的鯧	的繁体
鯨	鯨	魚的鯨	的繁体
鯪	鯪	魚的鯪	的繁体
鯫	(鯫	小魚)的繁体
鯭	泥鯭	的鯭	的繁体
鯰	鯰	魚的鯰	的繁体
鯶	(鯶	同鯇魚的鯇)的繁体
鯷	鯷	魚的鯷	的繁体
鯽	鯽	魚的鯽	的繁体
鰂	鋛鰂	魚的鰂	的繁体
鰆	鰆	魚(又名馬駮魚)的鰆	的繁体
鰈	(鰈	魚名)的繁体
鰉	(鰉	魚名)的繁体
鰍	泥鰍	(魚名)的鰍	的繁体
鰒	鰒	魚(俗稱鮑魚)的鰒	的繁体
鰓	魚鰓	的鰓	的繁体
鰕	(鰕	同蝦蟹的蝦)的繁体
鰜	鰜	魚的鰜	的繁体
鰣	(鰣	魚名)的繁体
鰥	鰥	夫的鰥	的繁体
鰨	(鰨	比目魚的一類)的繁体
鰩	(鰩	魚類的一類科)的繁体
鰭	魚鰭	的鰭	的繁体
鰱	鰱	魚的鰱	的繁体
鰲	鰲	頭的鰲	的繁体
鰳	鰳	魚的鰳	的繁体
鰷	鰷	魚的鰷	的繁体
鰹	鰹	魚的鰹	的繁体
鰻	鰻	魚的鰻	的繁体
鰽	盲鰽	的鰽	的繁体
鰾	魚鰾	的鰾	的繁体
鱄	鱄	魚的鱄	的繁体
鱅	鱅	魚的鱅	的繁体
鱈	鱈	魚的鱈	的繁体
鱉	鱉	魚的鱉	的繁体
鱏	(鱏	同鱘魚的鱘)的繁体
鱒	鱒	魚的鱒	的繁体
鱓	(鱓	同鱔魚的鱔)的繁体
鱔	鱔	魚的鱔	的繁体
鱖	鱖	魚的鱖	的繁体
鱗	鱗	片的鱗	的繁体
鱘	鱘	魚的鱘	的繁体
鱞	(鱞	同鰥夫的鰥)的繁体
鱟	鱟	地坊(地名)的鱟	的繁体
鱠	(鱠	鰳魚)的繁体
鱧	(鱧	魚類的一科)的繁体
鱲	赤鱲	角的鱲	的繁体
鱷	鱷	魚的鱷	的繁体
鱸	鱸	魚的鱸	的繁体
鱺	鰻鱺	的鱺	的繁体
鱻	(鱻	同新鮮的鮮)的繁体
鲊	(鲊	白鮓的鮓的簡寫)的繁体
鲗	(鲗	鋛鰂魚的鰂的簡寫)的繁体
鳀	(鳀	鯷魚的鯷的簡寫)的繁体
鳒	(鳒	鰜魚的鰜的簡寫)的繁体
鳥	雀鳥	的鳥	的繁体
鳩	斑鳩	的鳩	的繁体
鳲	鳲	鳩的鳲	的繁体
鳳	鳳	凰的鳳	的繁体
鳴	鳴	謝的鳴	的繁体
鳶	鳶	山的鳶	的繁体
鴃	(鴃	鳥名)的繁体
鴆	飲鴆	止渴的鴆	的繁体
鴇	鴇	妓的鴇	的繁体
鴉	烏鴉	的鴉	的繁体
鴒	鶺鴒	(鳥名)的鴒	的繁体
鴕	鴕	鳥的鴕	的繁体
鴛	鴛	鴦的鴛	的繁体
鴝	歌鴝	的鴝	的繁体
鴞	鴟鴞	的鴞	的繁体
鴟	鴟	鴞(鳥名)的鴟	的繁体
鴠	鶡鴠	(鳥名)的鴠	的繁体
鴣	鷓鴣	的鴣	的繁体
鴦	鴛鴦	的鴦	的繁体
鴨	烤鴨	的鴨	的繁体
鴻	鴻	圖的鴻	的繁体
鴿	白鴿	的鴿	的繁体
鵂	(鵂	貓頭鷹)的繁体
鵄	(鵄	同鴟鴞的鴟)(鳥名)的繁体
鵋	鵋	鷏(即貓頭鷹)的鵋	的繁体
鵑	杜鵑	的鵑	的繁体
鵒	鴝鵒	(鳥名)的鵒	的繁体
鵓	鵓	鴣的鵓	的繁体
鵙	暗灰鵑鵙	的鵙	的繁体
鵚	鵚	鶖(水鳥名)的鵚	的繁体
鵜	鵜	殿長照的鵜	的繁体
鵝	天鵝	的鵝	的繁体
鵞	(鵞	同天鵝的鵝)的繁体
鵠	鴻鵠	的鵠	的繁体
鵡	鸚鵡	的鵡	的繁体
鵪	鵪	鶉的鵪	的繁体
鵬	大鵬	鳥的鵬	的繁体
鵰	大鵰	的鵰	的繁体
鵲	喜鵲	的鵲	的繁体
鵶	(鵶	同烏鴉的鴉)的繁体
鵷	(鵷	鳥名)的繁体
鶇	烏鶇	的鶇	的繁体
鶉	鵪鶉	的鶉	的繁体
鶖	鵚鶖	(水鳥名)的鶖	的繁体
鶘	鵜鶘	(鳥名)的鶘	的繁体
鶚	(鶚	鳥名)的繁体
鶡	鶡	鴠(鳥名)的鶡	的繁体
鶩	趨之若鶩	的鶩	的繁体
鶪	(鶪	鳥名)的繁体
鶬	(鶬	鳥名即黃鸝)的繁体
鶯	黃鶯	的鶯	的繁体
鶴	白鶴	的鶴	的繁体
鶵	(鶵	幼小的鳥禽)的繁体
鶺	鶺	鴒(鳥名)的鶺	的繁体
鶻	(鶻	鳥名)的繁体
鶼	(鶼	古代傳說中的比翼鳥)的繁体
鶿	鸕鶿	(鳥名)的鶿	的繁体
鷁	(鷁	水鳥名)的繁体
鷄	(鷄	同雞蛋的雞)的繁体
鷓	鷓	鴣的鷓	的繁体
鷖	水鷖	(鳥名)的鷖	的繁体
鷗	海鷗	的鷗	的繁体
鷙	鷙	鷹(鳥名)的鷙	的繁体
鷚	田鷚	的鷚	的繁体
鷥	鷺鷥	的鷥	的繁体
鷦	鷦	鷯(鳥名)的鷦	的繁体
鷯	鷦鷯	(鳥名)的鷯	的繁体
鷲	(鷲	鳥名)的繁体
鷳	(鷳	鳥名)的繁体
鷸	鷸	蚌相爭的鷸	的繁体
鷹	麻鷹	的鷹	的繁体
鷺	白鷺	的鷺	的繁体
鸕	鸕	鶿(鳥名)的鸕	的繁体
鸚	鸚	鵡的鸚	的繁体
鸛	鸛	鳥的鸛	的繁体
鸜	(鸜	同歌鴝的鴝)的繁体
鸝	黃鸝	(鳥名)的鸝	的繁体
鸞	鸞	鳳和鳴的鸞	的繁体
鸤	(鸤	鳲鳩的鳲的簡寫)的繁体
鸰	(鸰	鶺鴒的鴒的簡寫)(鳥名)的繁体
鹓	(鹓	鵷行的鵷的簡寫)的繁体
鹖	(鹖	鶡鴠的鶡的簡寫)(鳥名)的繁体
鹙	(鹙	鵚鶖的鶖的簡寫)(水鳥名)的繁体
鹡	(鹡	鶺鴒的鶺的簡寫)(鳥名)的繁体
鹥	(鹥	水鷖的鷖的簡寫)(鳥名)的繁体
鹵	鹵	味的鹵	的繁体
鹹	鹹	苦的鹹	的繁体
鹻	(鹻	同鹼性的鹼)的繁体
鹼	(鹼	化學名稱)的繁体
鹽	食鹽	的鹽	的繁体
麀	麀	子的麀	的繁体
麁	(麁	同粗幼的粗)的繁体
麄	(麄	同粗幼的粗)的繁体
麌	(麌	牝或牡鹿)的繁体
麑	(麑	小鹿)的繁体
麗	美麗	的麗	的繁体
麢	(麢	同羚羊的羚)的繁体
麥	大麥	的麥	的繁体
麩	麥麩	的麩	的繁体
麪	(麪	麵包的麵的簡寫)的繁体
麵	麵	包的麵	的繁体
麹	(麹	麴菌的麴的簡寫)的繁体
麺	(麺	麵包的麵的簡寫)的繁体
麼	甚麼	的麼	的繁体
黃	黃	色的黃	的繁体
黌	黌	宮的黌	的繁体
黐	黐	貼的黐	的繁体
點	缺點	的點	的繁体
黡	(黡	黶子的黶的簡寫)(黑斑或黑痣)的繁体
黨	政黨	的黨	的繁体
黱	(黱	同林黛玉的黛)的繁体
黴	黴	菌的黴	的繁体
黵	黵	面(在面上刺黑字)的黵	的繁体
黶	黶	子(黑斑或黑痣)的黶	的繁体
黷	黷	武的黷	的繁体
黿	黿	魚的黿	的繁体
鼁	(鼁	蟲名)的繁体
鼃	(鼃	同青蛙的蛙)的繁体
鼄	(鼄	同蜘蛛的蛛)的繁体
鼅	(鼅	同蜘蛛的蜘)(昆蟲名)的繁体
鼇	鼇	頭的鼇	的繁体
鼉	鼉	鼓的鼉	的繁体
鼌	(鼌	晁蓋的晁的簡寫)的繁体
鼕	鼕	鼕	的鼕	的繁体
鼖	(鼖	古代的軍用大鼓)的繁体
鼦	(鼦	同貂皮的貂)的繁体
鼩	鼩	鼱(動物名)的鼩	的繁体
鼪	(鼪	鼬鼠)的繁体
鼫	(鼫	松鼠)的繁体
鼱	鼩鼱	(動物名)的鼱	的繁体
鼴	鼴	鼠的鼴	的繁体
齁	齁	聲(鼻鼾聲)的齁	的繁体
齇	(齇	酒糟鼻)的繁体
齊	齊	全的齊	的繁体
齋	齋	菜的齋	的繁体
齌	(齌	炊火猛烈)的繁体
齎	齎	恨的齎	的繁体
齏	(齏	細碎或粉狀)的繁体
齒	牙齒	的齒	的繁体
齕	齮齕	(咬)的齕	的繁体
齗	(齗	同牙齦的齦)的繁体
齙	齙	牙(突出嘴唇外的牙齒)的齙	的繁体
齜	齜	牙的齜	的繁体
齟	齟	齬的齟	的繁体
齠	(齠	兒童換牙)的繁体
齡	年齡	的齡	的繁体
齣	一齣	好戲的齣	的繁体
齦	牙齦	的齦	的繁体
齧	(齧	用牙咬物)的繁体
齩	(齩	同咬人的咬)的繁体
齪	齷齪	的齪	的繁体
齬	齟齬	的齬	的繁体
齮	齮	齕(咬)的齮	的繁体
齲	齲	齒的齲	的繁体
齶	齶	裂的齶	的繁体
齷	齷	齪的齷	的繁体
龁	(龁	齮齕的齕的簡寫)(咬)的繁体
龂	(龂	牙齦的齦的簡寫)的繁体
龍	龍	鳳的龍	的繁体
龎	(龎	同龐大的龐)的繁体
龐	龐	大的龐	的繁体
龔	(姓氏龔	)的繁体
龕	骨灰龕	的龕	的繁体
龜	烏龜	的龜	的繁体
龝	(龝	同秋天的秋)的繁体
龢	(龢	同和平的和)的繁体
龣	(龣	同角色的角)的繁体
龤	(龤	同詼諧的諧)的繁体
龥	(龥	同呼籲的籲)的繁体
豈	(豈	同豈敢的豈)的繁体
更	(更	同更好的更)的繁体
車	(車	同汽車的車)的繁体
賈	(賈	同商賈的賈)的繁体
滑	(滑	同滑稽的滑)的繁体
串	(串	同串連的串)的繁体
句	(句	同句子的句)的繁体
龜	(龜	同烏龜的龜)的繁体
龜	(龜	同烏龜的龜)的繁体
契	(契	同契約的契)的繁体
金	(金	同黃金的金)的繁体
喇	(喇	同喇叭的喇)的繁体
奈	(奈	同無奈的奈)的繁体
懶	(懶	同懶惰的懶)的繁体
癩	(癩	同癩蛤蟆的癩)的繁体
羅	(羅	同羅列的羅)的繁体
蘿	(蘿	同蘿蔔的蘿)的繁体
螺	(螺	同響螺的螺)的繁体
裸	(裸	同裸體的裸)的繁体
邏	(邏	同邏輯的邏)的繁体
樂	(樂	同快樂的樂)的繁体
洛	(洛	同洛陽的洛)的繁体
烙	(烙	同烙印的烙)的繁体
珞	(珞	同珞巴族的珞)的繁体
落	(落	同落後的落)的繁体
酪	(酪	同乳酪的酪)的繁体
駱	(駱	同駱駝的駱)的繁体
亂	(亂	同混亂的亂)的繁体
卵	(卵	同卵子的卵)的繁体
欄	(欄	同欄杆的欄)的繁体
爛	(爛	同破爛的爛)的繁体
蘭	(蘭	同蘭花的蘭)的繁体
鸞	(鸞	同鷺鷥的鷥)的繁体
嵐	(嵐	同山嵐瘴氣的嵐)的繁体
濫	(濫	同濫用的濫)的繁体
藍	(藍	同藍色的藍)的繁体
襤	(襤	同襤褸的襤)的繁体
拉	(拉	同拉扯的拉)的繁体
臘	(臘	同臘肉的臘)的繁体
蠟	(蠟	同蠟燭的蠟)的繁体
廊	(廊	同酒廊的廊)的繁体
朗	(朗	同朗誦的朗)的繁体
浪	(浪	同浪費的浪)的繁体
狼	(狼	同狼狽的狼)的繁体
郎	(郎	同牛郎的郎)的繁体
來	(來	同來往的來)的繁体
冷	(冷	同冷靜的冷)的繁体
勞	(勞	同勞動的勞)的繁体
擄	(擄	同擄劫的擄)的繁体
櫓	(櫓	同搖櫓的櫓)的繁体
爐	(爐	同火爐的爐)的繁体
盧	(盧	同盧布的盧)的繁体
老	(老	同年老的老)的繁体
蘆	(蘆	同葫蘆的蘆)的繁体
虜	(虜	同俘虜的虜)的繁体
路	(路	同路途的路)的繁体
露	(露	同暴露的露)的繁体
魯	(魯	同魯莽的魯)的繁体
鷺	(鷺	同白鷺的鷺)的繁体
碌	(碌	同忙碌的碌)的繁体
祿	(祿	同福祿的祿)的繁体
綠	(綠	同綠色的綠)的繁体
錄	(錄	同記錄的錄)的繁体
鹿	(鹿	同梅花鹿的鹿)的繁体
論	(論	同討論的論)的繁体
壟	(壟	同壟斷的壟)的繁体
弄	(弄	同玩弄的弄)的繁体
籠	(籠	同鳥籠的籠)的繁体
聾	(聾	同聾啞的聾)的繁体
牢	(牢	同牢固的牢)的繁体
磊	(磊	同磊落的磊)的繁体
賂	(賂	同賄賂的賂)的繁体
雷	(雷	同雷電的雷)的繁体
壘	(壘	同堡壘的壘)的繁体
屢	(屢	同屢次的屢)的繁体
樓	(樓	同樓房的樓)的繁体
淚	(淚	同眼淚的淚)的繁体
漏	(漏	同漏洞的漏)的繁体
累	(累	同連累的累)的繁体
縷	(縷	同縷縷炊煙的縷)的繁体
陋	(陋	同簡陋的陋)的繁体
勒	(勒	同勒索的勒)的繁体
肋	(肋	同肋骨的肋)的繁体
凜	(凜	同凜冽的凜)的繁体
凌	(凌	同凌亂的凌)的繁体
稜	(稜	同稜鏡的稜)的繁体
綾	(綾	同綾羅綢緞的綾)的繁体
菱	(菱	同菱角的菱)(植物)的繁体
陵	(陵	同丘陵的陵)的繁体
讀	(讀	同讀書的讀)的繁体
拏	(拏	同拏住的拏)的繁体
樂	(樂	同快樂的樂)的繁体
諾	(諾	同諾言的諾)的繁体
丹	(丹	同丹青的丹)的繁体
寧	(寧	同寧靜的寧)的繁体
怒	(怒	同憤怒的怒)的繁体
率	(率	同利率的率)的繁体
異	(異	同異同的異)的繁体
北	(北	同北方的北)的繁体
便	(便	同便利的便)的繁体
復	(復	同恢復的復)的繁体
不	(不	同不凡的不)的繁体
泌	(泌	同分泌的泌)的繁体
數	(數	同數學的數)的繁体
索	(索	同索取的索)的繁体
參	(參	同參與的參)的繁体
塞	(塞	同阻塞的塞)的繁体
省	(省	同節省的省)的繁体
葉	(葉	同樹葉的葉)的繁体
說	(說	同說話的說)的繁体
殺	(殺	同殺人的殺)的繁体
辰	(辰	同時辰的辰)的繁体
沈	(沈	同消沈的沈)的繁体
拾	(拾	同拾起的拾)的繁体
若	(若	同若干的若)的繁体
掠	(掠	同侵掠的掠)的繁体
略	(略	同戰略的略)的繁体
亮	(亮	同漂亮的亮)的繁体
兩	(兩	同兩個的兩)的繁体
梁	(梁	同梁啟超的梁)的繁体
糧	(糧	同糧食的糧)的繁体
良	(良	同良好的良)的繁体
諒	(諒	同原諒的諒)的繁体
量	(量	同大量的量)的繁体
勵	(勵	同鼓勵的勵)的繁体
呂	(呂	同呂布的呂)的繁体
女	(女	同男女的女)的繁体
廬	(廬	同盧布的盧)的繁体
旅	(旅	同旅行的旅)的繁体
濾	(濾	同濾水器的濾)的繁体
礪	(礪	同磨礪的礪)的繁体
閭	(閭	同三閭大夫的閭)的繁体
驪	(驪	同驪山的驪)的繁体
麗	(麗	同美麗的麗)的繁体
黎	(黎	同黎明的黎)的繁体
力	(力	同力量的力)的繁体
曆	(曆	同農曆的曆)的繁体
歷	(歷	同歷史的歷)的繁体
轢	(轢	同凌轢的轢)(欺凌)的繁体
年	(年	同年齡的年)的繁体
憐	(憐	同可憐的憐)的繁体
戀	(戀	同戀愛的戀)的繁体
撚	(撚	同撚骨的撚)的繁体
漣	(漣	同漣漪的漣)的繁体
煉	(煉	同煉鋼的煉)的繁体
璉	(璉	同箕璉坊的璉)的繁体
秊	(秊	同年齡的年)的繁体
練	(練	同練習的練)的繁体
聯	(聯	同聯合的聯)的繁体
輦	(輦	同鳳輦的輦)的繁体
蓮	(蓮	同蓮花的蓮)的繁体
連	(連	同連接的連)的繁体
鍊	(鍊	同拉鍊的鍊)的繁体
列	(列	同列出的列)的繁体
劣	(劣	同優劣的劣)的繁体
咽	(咽	同咽喉的咽)的繁体
烈	(烈	同熱烈的烈)的繁体
裂	(裂	同裂開的裂)的繁体
說	(說	同說話的說)的繁体
廉	(廉	同廉潔的廉)的繁体
念	(念	同紀念的念)的繁体
捻	(捻	同揉捻的捻)的繁体
殮	(殮	同殮房的殮)的繁体
簾	(簾	同窗簾的簾)的繁体
獵	(獵	同獵人的獵)的繁体
令	(令	同命令的令)的繁体
囹	(囹	同囹圄的囹)的繁体
寧	(寧	同寧靜的寧)的繁体
嶺	(嶺	同山嶺的嶺)的繁体
玲	(玲	同玲瓏的玲)的繁体
瑩	(瑩	同晶瑩的瑩)的繁体
羚	(羚	同羚羊的羚)的繁体
聆	(聆	同聆聽的聆)的繁体
鈴	(鈴	同門鈴的鈴)的繁体
零	(零	同零售的零)的繁体
靈	(靈	同靈魂的靈)的繁体
領	(領	同領導的領)的繁体
例	(例	同例子的例)的繁体
禮	(禮	同禮貌的禮)的繁体
醴	(醴	同醴泉的醴)的繁体
隸	(隸	同隸屬的隸)的繁体
惡	(惡	同兇惡的惡)的繁体
了	(了	同了解的了)的繁体
僚	(僚	同官僚的僚)的繁体
寮	(寮	同寮屋的寮)的繁体
尿	(尿	同屎尿的尿)的繁体
料	(料	同料理的料)的繁体
樂	(樂	同快樂的樂)的繁体
燎	(燎	同燎原的燎)的繁体
療	(療	同治療的療)的繁体
遼	(遼	同遼闊的遼)的繁体
龍	(龍	同龍鳳的龍)的繁体
暈	(暈	同暈倒的暈)的繁体
阮	(阮	同阮玲玉的阮)的繁体
劉	(劉	同劉邦的劉)的繁体
柳	(柳	同楊柳的柳)的繁体
流	(流	同流動的流)的繁体
溜	(溜	同溜走的溜)的繁体
琉	(琉	同琉璃的琉)的繁体
留	(留	同停留的留)的繁体
硫	(硫	同硫磺的硫)的繁体
紐	(紐	同紐約的紐)的繁体
類	(類	同種類的類)的繁体
六	(六	同六合彩的六)的繁体
戮	(戮	同殺戮的戮)的繁体
陸	(陸	同陸地的陸)的繁体
倫	(倫	同倫理的倫)的繁体
崙	(崙	同崑崙山的崙)的繁体
淪	(淪	同淪落的淪)的繁体
輪	(輪	同輪流的輪)的繁体
律	(律	同規律的律)的繁体
慄	(慄	同顫慄的慄)的繁体
栗	(栗	同栗子的栗)的繁体
率	(率	同利率的率)的繁体
隆	(隆	同隆重的隆)的繁体
利	(利	同利益的利)的繁体
吏	(吏	同官吏的吏)的繁体
履	(履	同履行的履)的繁体
易	(易	同容易的易)的繁体
李	(李	同行李的李)的繁体
梨	(梨	同雪梨的梨)的繁体
泥	(泥	同泥土的泥)的繁体
理	(理	同理由的理)的繁体
痢	(痢	同痢疾的痢)的繁体
罹	(罹	同罹難的罹)的繁体
裏	(裏	同這裏的裏)的繁体
裡	(裡	同裡面的裡)的繁体
里	(里	同萬里的里)的繁体
離	(離	同離開的離)的繁体
匿	(匿	同匿名的匿)的繁体
溺	(溺	同溺愛的溺)的繁体
吝	(吝	同吝嗇的吝)的繁体
燐	(燐	同燐火的燐)的繁体
藺	(藺	同藺相如的藺)的繁体
鱗	(鱗	同鱗片的鱗)的繁体
麟	(麟	同麒麟的麟)的繁体
林	(林	同森林的林)的繁体
淋	(淋	同淋花的淋)的繁体
臨	(臨	同臨時的臨)的繁体
立	(立	同建立的立)的繁体
笠	(笠	同笠衫的笠)的繁体
粒	(粒	同粒粒的粒)的繁体
狀	(狀	同狀況的狀)的繁体
炙	(炙	同炙手可熱的炙)的繁体
識	(識	同智識的識)的繁体
什	(什	同什麼的什)(常用寫法)的繁体
茶	(茶	同茶葉的茶)的繁体
刺	(刺	同刺激的刺)的繁体
切	(切	同切開的切)的繁体
度	(度	同態度的度)的繁体
拓	(拓	同拓展的拓)的繁体
糖	(糖	同糖果的糖)的繁体
宅	(宅	同住宅的宅)的繁体
洞	(洞	同洞穴的洞)的繁体
暴	(暴	同暴動的暴)的繁体
輻	(輻	同輻射的輻)的繁体
行	(行	同步行的行)的繁体
降	(降	同升降的降)的繁体
見	(見	同看見的見)的繁体
廓	(廓	同輪廓的廓)的繁体
兀	兀	自的兀	的繁体
塚	(塚	同衣棺塚的塚)的繁体
晴	(晴	同晴朗的晴)的繁体
益	(益	同利益的益)的繁体
礼	(礼	同禮貌的禮)的繁体
神	(神	同神奇的神)的繁体
祥	(祥	同慈祥的祥)的繁体
福	(福	同福氣的福)的繁体
靖	(靖	同嘉靖的靖)的繁体
精	(精	同精神的精)的繁体
羽	(羽	同羽毛的羽)的繁体
諸	(諸	同諸侯的諸)的繁体
逸	(逸	同安逸的逸)的繁体
都	(都	同都市的都)的繁体
飯	(飯	同米飯的飯)的繁体
飼	(飼	同飼養的飼)的繁体
館	(館	同飯館的館)的繁体
鶴	(鶴	同白鶴的鶴)的繁体
侮	(同侮辱的侮)的繁体
僧	(同僧侶的僧)的繁体
免	(同免費的免)的繁体
勉	(同勉強的勉)的繁体
勤	(同勤力的勤)的繁体
卑	(同尊卑的卑)的繁体
喝	(同喝水的喝)的繁体
嘆	(同嘆氣的嘆)的繁体
器	(同器材的器)的繁体
墨	(同墨水的墨)的繁体
層	(同層次的層)的繁体
悔	(同悔改的悔)的繁体
慨	(同慨嘆的慨)的繁体
憎	(同憎恨的憎)的繁体
懲	(同懲罰的懲)的繁体
敏	(同敏感的敏)的繁体
既	(同既然的既)的繁体
暑	(同暑假的暑)的繁体
梅	(同梅花的梅)的繁体
海	(同海洋的海)的繁体
渚	(同渚槽的渚)的繁体
漢	(同漢字的漢)的繁体
煮	(同煮飯的煮)的繁体
琢	(同琢磨的琢)的繁体
碑	(同石碑的碑)的繁体
社	(同社會的社)的繁体
祉	(同福祉的祉)的繁体
祈	(同祈禱的祈)的繁体
祐	(同庇祐的祐)的繁体
祖	(同祖宗的祖)的繁体
祝	(同祝賀的祝)的繁体
禍	(同禍害的禍)的繁体
禎	(同崇禎的禎)(人名)的繁体
穀	(同穀物的穀)的繁体
突	(同突然的突)的繁体
節	(同節日的節)的繁体
練	(同練習的練)的繁体
縉	(同縉皇居的縉)的繁体
繁	(同繁榮的繁)的繁体
署	(同部署的署)的繁体
者	(同記者的者)的繁体
臭	(同臭味的臭)的繁体
著	(同著手的著)的繁体
褐	(同褐色的褐)的繁体
視	(同視覺的視)的繁体
謁	(同謁見的謁)的繁体
謹	(同謹慎的謹)的繁体
賓	(同賓客的賓)的繁体
贈	(同贈送的贈)的繁体
逸	(同安逸的逸)的繁体
難	(同困難的難)的繁体
響	(同響應的響)的繁体
頻	(同頻率的頻)的繁体
唄	嘆詞的唄	,敗唱的敗的繁体
幬	愁帳的愁,稻覆的稻的繁体
濼	血頗的頗,洛水的洛的繁体
澮	快水的快,噦河的噦的繁体
澠	繩水的繩,澠	池的沔的繁体
駘	駑臺的臺,代蕩的代的繁体
紇	回合的合,線割的割的繁体
緶	帶變的變,篇縫的篇的繁体
繰	敲邊的敲,繅絲的繅的繁体
鈀	金把的把,耙地的耙的繁体
鈿	金電的電,銅田的田的繁体
鐔	新器的新,姓談的談的繁体
黽	敏勉的敏,猛窟的猛的繁体
餳	餳	面的餳	的繁体
撣	撣	土的撣	的繁体
堿	酸堿	的堿	的繁体
墻	墻	壁的墻	的繁体
墑	保墑	的墑	的繁体
撾	老撾	的撾	的繁体
鄖	鄖	縣的鄖	的繁体
鍺	金鍺	的鍺	的繁体
鉆	鉆	研的鉆	的繁体
賾	微賾	的賾	的繁体
俁	俁	俁	的俁	的繁体
儺	儺	神的儺	的繁体
囅	囅	然的囅	的繁体
鳧	野鴨的鳧	的繁体
詘	詘	縮的詘	的繁体
詿	詿	誤的詿	的繁体
諑	諑	毀的諑	的繁体
諗	諗	知的諗	的繁体
諞	諞	能的諞	的繁体
巹	合巹	的巹	的繁体
鄶	鄶	國的鄶	的繁体
巰	巰	基的巰	的繁体
埡	埡	口的埡	的繁体
塏	爽塏	的塏	的繁体
塒	塒	窩的塒	的繁体
塤	陶塤	的塤	的繁体
薌	薌	江的薌	的繁体
蕓	蕓	豆的蕓	的繁体
蓯	蓯	蓉的蓯	的繁体
芐	草芐	的芐	的繁体
蕘	蕘	花的蕘	的繁体
藎	藎	草的藎	的繁体
薟	薟	草的薟	的繁体
蕕	蕕	草的蕕	的繁体
蕆	蕆	事的蕆	的繁体
蕢	包蕢	的蕢	的繁体
蘺	淋蘺	的蘺	的繁体
鎣	華鎣	的鎣	的繁体
蕷	薯蕷	的蕷	的繁体
蘞	白蘞	的蘞	的繁体
撟	撟	舉的撟	的繁体
攄	攄	意的攄	的繁体
擼	擼	下的擼	的繁体
搟	搟	面的搟	的繁体
咼	咼	斜的咼	的繁体
噦	鳥噦	的噦	的繁体
噲	噲	咽的噲	的繁体
嚌	品嘗的嚌	的繁体
嚳	帝嚳	的嚳	的繁体
轡	轡	頭的轡	的繁体
崠	崠	羅的崠	的繁体
崳	昆崳	的崳	的繁体
廡	廡	殿的廡	的繁体
懌	懌	歡的懌	的繁体
懨	懨	懨	的懨	的繁体
憒	昏憒	的憒	的繁体
閎	門閎	的閎	的繁体
閌	閌	閬的閌	的繁体
閫	規捆的閫	的繁体
閿	閿	鄉的閿	的繁体
閽	扣閽	的閽	的繁体
闃	闃	寂的闃	的繁体
潿	潿	洲的潿	的繁体
灄	灄	口的灄	的繁体
瀅	瀅	清的瀅	的繁体
潷	水潷	的潷	的繁体
弳	弧弳	的弳	的繁体
嬙	妃嬙	的嬙	的繁体
駔	馬駔	的駔	的繁体
驤	馬驤	的驤	的繁体
紿	欺紿	的紿	的繁体
絎	絎	被的絎	的繁体
緙	緙	絲的緙	的繁体
緗	緗	素的緗	的繁体
繢	絲繢	的繢	的繁体
緦	緦	布的緦	的繁体
緱	緱	氏的緱	的繁体
緡	緡	繩的緡	的繁体
縭	結縭	的縭	的繁体
頊	姓頊	的頊	的繁体
榪	榪	頭的榪	的繁体
欞	窗欞	的欞	的繁体
槧	宋槧	的槧	的繁体
槨	棺槨	的槨	的繁体
檁	檁	條的檁	的繁体
殤	殤	亡的殤	的繁体
殫	殫	力的殫	的繁体
軹	軹	城的軹	的繁体
輇	輇	才的輇	的繁体
戧	戧	風的戧	的繁体
賚	賞賚	的賚	的繁体
賧	賧	佛的賧	的繁体
覯	見覯	的覯	的繁体
毿	毿	毿	的毿	的繁体
颮	颮	風的颮	的繁体
熗	熗	鍋的熗	的繁体
澩	澩	泉的澩	的繁体
礱	礱	糠的礱	的繁体
磽	磽	薄的磽	的繁体
脧	脧	視的脧	的繁体
鍆	金鍆	的鍆	的繁体
鈑	金鈑	的鈑	的繁体
鈄	姓鈄	的鈄	的繁体
鈳	金鈳	的鈳	的繁体
鈽	金版的鈽	的繁体
鉞	金鉞	的鉞	的繁体
鉭	金鉭	的鉭	的繁体
鈰	金鈰	的鈰	的繁体
鈮	金鈮	的鈮	的繁体
鋏	劍鋏	的鋏	的繁体
銃	銃	子的銃	的繁体
鋱	金鋱	的鋱	的繁体
鋨	金鋨	的鋨	的繁体
鋝	金鋝	的鋝	的繁体
鋟	鋟	版的鋟	的繁体
鋦	鋦	盆的鋦	的繁体
錆	金錆	的錆	的繁体
錛	錛	子的錛	的繁体
錁	金錁	的錁	的繁体
錈	錈	刃的錈	的繁体
錟	錟	矛的錟	的繁体
鍇	好鐵的鍇	的繁体
鍶	金鍶	的鍶	的繁体
鍤	鐵鍤	的鍤	的繁体
鎪	鎪	子的鎪	的繁体
鐨	金鐨	的鐨	的繁体
鎦	鎦	金的鎦	的繁体
鎵	金鎵	的鎵	的繁体
鏍	羅金的鏍	的繁体
鐓	冷鐓	的鐓	的繁体
鴯	鴯	鹋的鴯	的繁体
鴰	老鴰	的鴰	的繁体
鷴	鳥鷴	的鷴	的繁体
鵯	鵯	鳥的鵯	的繁体
鷂	鷂	鷹的鷂	的繁体
癉	病癉	的癉	的繁体
瘞	瘞	葬的瘞	的繁体
瘺	瘺	管的瘺	的繁体
窶	窶	窮的窶	的繁体
褳	褡褳	的褳	的繁体
耬	耬	地的耬	的繁体
頏	頡頏	的頏	的繁体
蟣	蟲蟣	的蟣	的繁体
簀	竹簀	的簀	的繁体
篋	藤篋	的篋	的繁体
秈	秈	米的秈	的繁体
糶	米糶	的糶	的繁体
縶	縶	韁的縶	的繁体
趲	趲	趕的趲	的繁体
鹺	鹺	鹽的鹺	的繁体
躒	躒	走的躒	的繁体
蹕	蹕	行的蹕	的繁体
躦	躦	上的躦	的繁体
齔	齔	牙的齔	的繁体
鮒	鮒	鯽的鮒	的繁体
鮐	鮐	魚的鮐	的繁体
鮚	魚鮚	的鮚	的繁体
鮞	魚鮞	的鮞	的繁体
鱭	鳳鱭	的鱭	的繁体
鯡	鯡	魚的鯡	的繁体
黲	黲	黷的黲	的繁体
